哦啊车	o'a'che	0
哦啊捏	o'a'nie	0
哦爱不好啊	o'ai'bu'hao'a	0
哦爱哦爱	o'ai'o'ai	0
哦安康	o'an'kang	0
哦昂写	o'ang'xie	0
哦办不到	o'ban'bu'dao	0
哦班上	o'ban'shang	0
哦保持	o'bao'chi	0
哦包邮	o'bao'you	0
哦奔	o'ben	0
哦比	o'bi	0
哦逼	o'bi	0
哦表	o'biao	0
哦憋	o'bie	0
哦伯明翰	o'bo'ming'han	0
噢不	o'bu	0
哦不错哦	o'bu'cuo'o	0
哦不对	o'bu'dui	0
哦不换算	o'bu'huan'suan	0
噢布力	o'bu'li	0
噢布里江	o'bu'li'jiang	0
噢布力喀斯木	o'bu'li'ka'si'mu	0
哦不没有以后了	o'bu'mei'you'yi'hou'le	0
哦擦	o'ca	0
噢槽	o'cao	0
哦草嗷嗷嗷	o'cao'ao'ao'ao	0
哦册那	o'ce'na	0
哦昌	o'chang	0
哦超	o'chao	0
哦成诗句	o'cheng'shi'ju	0
哦戳	o'chuo	0
噢戳	o'chuo	0
哦粗	o'cu	0
哦错	o'cuo	0
哦大白痴	o'da'bai'chi	0
哦大吗	o'da'ma	0
哦带	o'dai	0
哦捣鼓东西呢	o'dao'gu'dong'xi'ne	0
哦得	o'de	0
哦的	o'de	0
哦得了	o'de'le	0
哦得了咯	o'de'le'ge	0
哦的人	o'de'ren	0
哦的事	o'de'shi	0
哦得走了	o'de'zou'le	0
哦滴	o'di	0
哦点	o'dian	0
哦吊	o'diao	0
哦冬	o'dong	0
哦都开	o'dou'kai	0
哦度开不了枪	o'du'kai'bu'liao'qiang	0
哦对的	o'dui'de	0
哦对哦	o'dui'o	0
哦对也	o'dui'ye	0
哦多开	o'duo'kai	0
哦多克	o'duo'ke	0
哦多尅	o'duo'kei	0
哦多茄	o'duo'qie	0
哦哆也	o'duo'ye	0
哦恩	o'en	0
哦恩啊	o'en'a	0
哦儿	o'er	0
哦伐	o'fa	0
噢发根	o'fa'gen	0
哦放的	o'fang'de	0
哦芳姐	o'fang'jie	0
哦放了	o'fang'le	0
哦飞	o'fei	0
哦噶	o'ga	0
哦尕	o'ga	0
哦改	o'gai	0
哦该	o'gai	0
哦该啊	o'gai'a	0
哦该吧	o'gai'ba	0
哦该不	o'gai'bu	0
哦该哒	o'gai'da	0
哦该达	o'gai'da	0
哦该的	o'gai'de	0
哦该搞	o'gai'gao	0
哦改咯	o'gai'ge	0
哦该咯	o'gai'ge	0
哦改了	o'gai'le	0
哦该了	o'gai'le	0
哦该类	o'gai'lei	0
哦该累	o'gai'lei	0
哦该咧	o'gai'lie	0
哦该囖	o'gai'luo	0
哦该罗	o'gai'luo	0
哦该呢	o'gai'ne	0
哦该捏	o'gai'nie	0
哦该诺	o'gai'nuo	0
哦该要	o'gai'yao	0
哦干嘛了	o'gan'ma'le	0
哦个	o'ge	0
哦咯	o'ge	0
噢咯	o'ge	0
哦咯嘛	o'ge'ma	0
哦个么	o'ge'me	0
哦个哦	o'ge'o	0
哦给哪了	o'gei'na'le	0
哦给我你把他还	o'gei'wo'ni'ba'ta'hai	0
哦过	o'guo	0
哦哈哟	o'ha'yo	0
哦哈哟米娜桑	o'ha'yo'mi'na'sang	0
哦还	o'hai	0
哦还咯	o'hai'ge	0
哦海洋	o'hai'yang	0
哦航班	o'hang'ban	0
哦杭州	o'hang'zhou	0
噢嚎	o'hao	0
哦好的	o'hao'de	0
哦好咯	o'hao'lo	0
哦好呀	o'hao'ya	0
哦呵	o'he	0
哦贺	o'he	0
哦呵呵哈哈哈哈哈哈	o'he'he'ha'ha'ha'ha'ha'ha	0
哦呵呵了	o'he'he'le	0
哦弘扬国学	o'hong'yang'guo'xue	0
哦吼	o'hou	0
噢喉	o'hou	0
哦吼哎	o'hou'ai	0
哦吼诶	o'hou'ei	0
哦呼	o'hu	0
哦胡	o'hu	0
哦湖塘	o'hu'tang	0
哦豁	o'huo	0
哦货	o'huo	0
哦霍	o'huo	0
哦姬蜂属	o'ji'feng'shu	0
哦寄给	o'ji'gei	0
哦加	o'jia	0
哦浆	o'jiang	0
哦酱	o'jiang	0
哦叫	o'jiao	0
哦娇娃	o'jiao'wa	0
哦接	o'jie	0
哦解	o'jie	0
哦接待	o'jie'dai	0
噢金鸡	o'jin'ji	0
哦就千诗一笑休	o'jiu'qian'shi'yi'xiao'xiu	0
哦卡	o'ka	0
噢哢弄	o'ka'nong	0
哦开	o'kai	0
哦看哦破皮	o'kan'o'po'pi	0
哦可	o'ke	0
哦磕	o'ke	0
哦科	o'ke	0
噢克阿哈德克村委会	o'ke'a'ha'de'ke'cun'wei'hui	0
哦啃了	o'ken'le	0
噢口弄	o'kou'nong	0
哦酷似	o'ku'si	0
哦快走	o'kuai'zou	0
哦拉	o'la	0
噢辣	o'la	0
哦啦啦	o'la'la	0
噢辣辣	o'la'la	0
哦啦哦啦哦啦	o'la'o'la'o'la	0
哦来	o'lai	0
哦朗	o'lang	0
哦勒	o'le	0
哦了逼	o'le'bi	0
哦了逼了	o'le'bi'le	0
哦了个空调	o'le'ge'kong'tiao	0
哦了吗	o'le'ma	0
哦了么	o'le'me	0
哦累死	o'lei'si	0
哦里	o'li	0
哦里的	o'li'de	0
哦痢肚	o'li'du	0
哦里搞	o'li'gao	0
哦里高	o'li'gao	0
哦里咯	o'li'ge	0
哦里拉	o'li'la	0
哦里了	o'li'le	0
哦咧	o'lie	0
噢琳达	o'lin'da	0
哦领	o'ling	0
哦漏	o'lou	0
哦吗	o'ma	0
哦嘛	o'ma	0
哦玛	o'ma	0
噢买尬	o'mai'ga	0
哦忙啊	o'mang'a	0
哦忙的	o'mang'de	0
哦忙了	o'mang'le	0
哦忙撒	o'mang'sa	0
哦么	o'me	0
哦咪	o'mi	0
哦米	o'mi	0
哦咩	o'mie	0
噢姆	o'mu	0
哦娜	o'na	0
哦那	o'na	0
哦那波	o'na'bo	0
哦那个电脑上	o'na'ge'dian'nao'shang	0
哦那个谁	o'na'ge'shui	0
哦那里现在	o'na'li'xian'zai	0
哦那你说	o'na'ni'shuo	0
哦那哦那	o'na'o'na	0
哦南昌	o'nan'chang	0
哦难怪不	o'nan'guai'bu	0
哦南京	o'nan'jing	0
哦南宁	o'nan'ning	0
哦内酱	o'nei'jiang	0
哦内置	o'nei'zhi	0
哦你	o'ni	0
哦你不领情	o'ni'bu'ling'qing	0
哦你工作回家	o'ni'gong'zuo'hui'jia	0
哦你家了	o'ni'jia'le	0
哦你家你若	o'ni'jia'ni'ruo	0
哦你可	o'ni'ke	0
哦你肯	o'ni'ken	0
哦你妹夫	o'ni'mei'fu	0
哦你哦	o'ni'o	0
哦你傻	o'ni'sha	0
哦你啥	o'ni'sha	0
哦你也路	o'ni'ye'lu	0
哦年英雄	o'nian'ying'xiong	0
哦尿	o'niao	0
哦尿尿	o'niao'niao	0
哦凝视	o'ning'shi	0
哦宁乡	o'ning'xiang	0
哦哝	o'nong	0
哦弄啥	o'nong'sha	0
哦农药	o'nong'yao	0
哦农业路	o'nong'ye'lu	0
哦诺	o'nuo	0
哦哦	o'o	0
哦哦啊	o'o'a	0
哦哦凤姐	o'o'feng'jie	0
哦哦干啥呢	o'o'gan'sha'ne	0
哦哦咯	o'o'ge	0
哦哦哈	o'o'ha	0
哦哦好的	o'o'hao'de	0
哦哦花园路	o'o'hua'yuan'lu	0
哦哦口	o'o'kou	0
哦哦马达	o'o'ma'da	0
哦哦米	o'o'mi	0
哦哦你傻了	o'o'ni'sha'le	0
哦哦哦	o'o'o	0
噢噢噢噢噢噢噢	o'o'o'o'o'o'o	0
噢噢噢噢跑	o'o'o'o'pao	0
哦哦情况	o'o'qing'kuang	0
哦哦时候	o'o'shi'hou	0
噢哦喔	o'o'wo	0
哦哦系咯	o'o'xi'lo	0
哦叛	o'pan	0
哦跑到哪儿去了	o'pao'dao'na'er'qu'le	0
哦朋友家	o'peng'you'jia	0
哦撇	o'pie	0
噢萍	o'ping	0
哦普通人	o'pu'tong'ren	0
哦千千	o'qian'qian	0
哦亲	o'qin	0
哦热	o're	0
哦任	o'ren	0
哦日	o'ri	0
哦肉	o'rou	0
哦儒	o'ru	0
噢若	o'ruo	0
哦塞	o'sai	0
哦扫	o'sao	0
哦骚	o'sao	0
哦涩	o'se	0
哦屎	o'shi	0
哦是	o'shi	0
哦诗出凡俗	o'shi'chu'fan'su	0
哦是的	o'shi'de	0
哦是滴	o'shi'di	0
哦诗敢夸博	o'shi'gan'kua'bo	0
哦是搞	o'shi'gao	0
哦诗更踌躇	o'shi'geng'chou'chu	0
哦是了	o'shi'le	0
哦诗清风起空谷	o'shi'qing'feng'qi'kong'gu	0
哦诗徒叹息	o'shi'tu'tan'xi	0
哦诗五百尽清警	o'shi'wu'bai'jin'qing'jing	0
哦诗想入秋塘景鸳鹭惊飞一夕忙	o'shi'xiang'ru'qiu'tang'jing'yuan'lu'jing'fei'yi'xi'mang	0
哦售后	o'shou'hou	0
哦刷新了	o'shua'xin'le	0
哦说下	o'shuo'xia	0
哦死	o'si	0
哦司搞	o'si'gao	0
哦死搞	o'si'gao	0
四四九	o'si'jiu	0
哦死咯	o'si'lo	0
噢斯曼	o'si'man	0
三四医院社区	o'si'yi'yuan'she'qu	0
哦送个	o'song'ge	0
哦苏珊娜	o'su'shan'na	0
哦索	o'suo	0
哦所谓	o'suo'wei	0
哦特	o'te	0
哦特码	o'te'ma	0
哦特么	o'te'me	0
哦提的	o'ti'de	0
哦通	o'tong	0
哦头	o'tou	0
哦哇	o'wa	0
哦晚上	o'wan'shang	0
哦为了	o'wei'le	0
哦喔	o'wo	0
哦我爱你耶稣	o'wo'ai'ni'ye'su	0
哦我慈爱的天父	o'wo'ci'ai'de'tian'fu	0
哦我的鬼神大人	o'wo'de'gui'shen'da'ren	0
哦我的皇帝陛下	o'wo'de'huang'di'bi'xia	0
哦我就知道	o'wo'jiu'zhi'dao	0
哦我开心	o'wo'kai'xin	0
哦我娘	o'wo'niang	0
哦我其实	o'wo'qi'shi	0
哦我亲爱的牛儿啊	o'wo'qin'ai'de'niu'er'a	0
哦我说挺熟	o'wo'shuo'ting'shu	0
哦吓	o'xia	0
哦虾类	o'xia'lei	0
哦笑了吗	o'xiao'le'ma	0
哦心	o'xin	0
哦行	o'xing	0
哦休	o'xiu	0
哦虚	o'xu	0
哦丫斯蜜	o'ya'si'mi	0
哦呀丝蜜	o'ya'si'mi	0
哦呀斯密呐赛	o'ya'si'mi'na'sai	0
哦呀子咪	o'ya'zi'mi	0
哦要	o'yao	0
哦液	o'ye	0
噢野	o'ye	0
噢耶屎	o'ye'shi	0
哦一	o'yi	0
噢易	o'yi	0
噢依巴格村委会	o'yi'ba'ge'cun'wei'hui	0
噢易计算机实验教学支撑系统	o'yi'ji'suan'ji'shi'yan'jiao'xue'zhi'cheng'xi'tong	0
哦议价	o'yi'jia	0
噢易科技	o'yi'ke'ji	0
哦咦哦咦啊	o'yi'o'yi'a	0
哦依然	o'yi'ran	0
噢依塔艾热克村委会	o'yi'ta'ai're'ke'cun'wei'hui	0
哦依稀	o'yi'xi	0
噢易系统卫士	o'yi'xi'tong'wei'shi	0
噢易系统卫士企业版	o'yi'xi'tong'wei'shi'qi'ye'ban	0
噢易系统卫士专业版	o'yi'xi'tong'wei'shi'zhuan'ye'ban	0
噢咿呀	o'yi'ya	0
噢易硬盘保护卡	o'yi'ying'pan'bao'hu'ka	0
噢易运维管理系统	o'yi'yun'wei'guan'li'xi'tong	0
噢易云桌面	o'yi'yun'zhuo'mian	0
哦印与	o'yin'yu	0
哦哟	o'yo	0
哦哟娘	o'yo'niang	0
哦哟哦哟	o'yo'o'yo	0
哦哟歪	o'yo'wai	0
哦哟喂	o'yo'wei	0
哦哟哟	o'yo'yo	0
哦哟哟哟	o'yo'yo'yo	0
哦用	o'yong	0
哦呦	o'you	0
哦有	o'you	0
哦由	o'you	0
哦呦娘	o'you'niang	0
哦呦喂	o'you'wei	0
哦有味	o'you'wei	0
哦呦呦	o'you'you	0
哦于	o'yu	0
哦院	o'yuan	0
哦在大庆	o'zai'da'qing	0
哦在这停顿	o'zai'zhe'ting'dun	0
哦赞美主哈利路亚	o'zan'mei'zhu'ha'li'lu'ya	0
哦则	o'ze	0
哦章	o'zhang	0
哦章生	o'zhang'sheng	0
哦真爱在我心	o'zhen'ai'zai'wo'xin	0
哦治	o'zhi	0
哦直径为	o'zhi'jing'wei	0
哦主啊	o'zhu'a	0
哦主求你保守	o'zhu'qiu'ni'bao'shou	0
哦主求你坚固	o'zhu'qiu'ni'jian'gu	0
哦子	o'zi	0
哦自搞地	o'zi'gao'di	0
哦租	o'zu	0
哦组	o'zu	0
哦组哦组	o'zu'o'zu	0
哦作	o'zuo	0
哦坐	o'zuo	0
欧阿革瑞	ou'a'ge'rui	0
偶啊快	ou'a'kuai	0
欧阿涅	ou'a'nie	0
欧爱克斯	ou'ai'ke'si	0
偶爱庐山家九江	ou'ai'lu'shan'jia'jiu'jiang	0
藕岸	ou'an	0
欧安大楼	ou'an'da'lou	0
欧安电气	ou'an'dian'qi	0
偶安逸	ou'an'yi	0
欧澳	ou'ao	0
偶巴	ou'ba	0
偶芭	ou'ba	0
呕粑	ou'ba	0
呕霸	ou'ba	0
欧坝	ou'ba	0
欧巴	ou'ba	0
欧把	ou'ba	0
欧霸	ou'ba	0
欧巴宾海蝎	ou'ba'bin'hai'xie	0
欧巴德	ou'ba'de	0
偶巴尔	ou'ba'er	0
偶巴尔坛	ou'ba'er'tan	0
偶吧肛门塞	ou'ba'gang'men'sai	0
欧巴赫尼克	ou'ba'he'ni'ke	0
欧巴克	ou'ba'ke	0
欧巴客	ou'ba'ke	0
欧巴罗	ou'ba'luo	0
欧巴莫森	ou'ba'mo'sen	0
欧巴桑	ou'ba'sang	0
欧巴桑向前冲	ou'ba'sang'xiang'qian'chong	0
欧巴斯	ou'ba'si	0
欧巴斯特	ou'ba'si'te	0
欧坝塘	ou'ba'tang	0
欧巴托	ou'ba'tuo	0
欧巴我们离婚吧	ou'ba'wo'men'li'hun'ba	0
欧拜	ou'bai	0
欧柏	ou'bai	0
欧白	ou'bai	0
欧白鲑	ou'bai'gui	0
欧拜亥	ou'bai'hai	0
欧白芥属	ou'bai'jie'shu	0
欧拜克	ou'bai'ke	0
欧白蜡树卷叶绵蚜	ou'bai'la'shu'juan'ye'mian'ya	0
欧柏莱	ou'bai'lai	0
欧柏兰奴	ou'bai'lan'nu	0
欧柏丽	ou'bai'li	0
欧柏丽凡士林柔润护手霜	ou'bai'li'fan'shi'lin'rou'run'hu'shou'shuang	0
欧柏丽牛奶高效保湿护手霜	ou'bai'li'niu'nai'gao'xiao'bao'shi'hu'shou'shuang	0
欧柏美地	ou'bai'mei'di	0
欧柏婷	ou'bai'ting	0
欧白鱼	ou'bai'yu	0
欧白芷	ou'bai'zhi	0
欧白芷精油	ou'bai'zhi'jing'you	0
欧白芷内酯	ou'bai'zhi'nei'zhi	0
欧伴	ou'ban	0
欧班	ou'ban	0
鏂板喍鍏徃	ou'ban'chai'wei'wang	0
鸥伴晨斋暖戏庭	ou'ban'chen'zhai'nuan'xi'ting	0
鏂颁簹鐧捐揣澶	ou'ban'dang'jian'juan'chuai'chan	0
偶伴孤云宿岭东	ou'ban'gu'yun'su'ling'dong	0
欧斑鸠	ou'ban'jiu	0
鏂伴棬鍙	ou'ban'juan'hu	0
鏂板崕涔簵	ou'ban'ya'cen'lu	0
鏂版柊婧愬競鍦	ou'ban'zhong'jing'shuo'jing'shi	0
欧磅	ou'bang	0
欧邦橱柜	ou'bang'chu'gui	0
欧邦英	ou'bang'ying	0
偶宝	ou'bao	0
欧堡	ou'bao	0
欧宝	ou'bao	0
瓯宝宝	ou'bao'bao	0
欧宝灿	ou'bao'can	0
欧宝璨	ou'bao'can	0
欧宝橱柜	ou'bao'chu'gui	0
欧宝大酒店	ou'bao'da'jiu'dian	0
欧宝大厦	ou'bao'da'sha	0
欧宝地板	ou'bao'di'ban	0
欧宝电器	ou'bao'dian'qi	0
欧宝服饰	ou'bao'fu'shi	0
欧宝机电	ou'bao'ji'dian	0
欧宝家具	ou'bao'jia'ju	0
欧堡利亚	ou'bao'li'ya	0
瓯堡路	ou'bao'lu	0
欧宝时尚家饰	ou'bao'shi'shang'jia'shi	0
欧宝涮园	ou'bao'shuan'yuan	0
欧堡西	ou'bao'xi	0
欧堡西餐	ou'bao'xi'can	0
欧堡西餐酒吧	ou'bao'xi'can'jiu'ba	0
欧宝装饰	ou'bao'zhuang'shi	0
偶北	ou'bei	0
欧北	ou'bei	0
欧背	ou'bei	0
欧贝	ou'bei	0
欧陂	ou'bei	0
瓯北	ou'bei	0
瓯北啊	ou'bei'a	0
瓯北吧	ou'bei'ba	0
欧倍德	ou'bei'de	0
瓯北陡门头	ou'bei'dou'men'tou	0
偶倍多倍体	ou'bei'duo'bei'ti	0
欧贝儿	ou'bei'er	0
欧贝尔	ou'bei'er	0
欧贝芬	ou'bei'fen	0
偶被功名涴我闲	ou'bei'gong'ming'yuan'wo'xian	0
欧贝佳安全套	ou'bei'jia'an'quan'tao	0
欧倍客	ou'bei'ke	0
瓯北客运中心	ou'bei'ke'yun'zhong'xin	0
欧贝拉	ou'bei'la	0
欧贝拉饼	ou'bei'la'bing	0
欧贝拉饼屋店	ou'bei'la'bing'wu'dian	0
欧贝拉饼屋外滩店	ou'bei'la'bing'wu'wai'tan'dian	0
欧贝拉饼屋吴淞店	ou'bei'la'bing'wu'wu'song'dian	0
欧北了	ou'bei'le	0
瓯北吗	ou'bei'ma	0
瓯北码头	ou'bei'ma'tou	0
瓯北那	ou'bei'na	0
瓯北哪里	ou'bei'na'li	0
瓯北呢	ou'bei'ne	0
瓯北人	ou'bei'ren	0
瓯北三中	ou'bei'san'zhong	0
瓯北商业街	ou'bei'shang'ye'jie	0
瓯北诗钞	ou'bei'shi'chao	0
瓯北诗话	ou'bei'shi'hua	0
偶被世人知	ou'bei'shi'ren'zhi	0
欧倍松	ou'bei'song	0
偶倍体	ou'bei'ti	0
偶被我	ou'bei'wo	0
瓯北五中	ou'bei'wu'zhong	0
瓯北新桥	ou'bei'xin'qiao	0
欧北亚柳叶蜂	ou'bei'ya'liu'ye'feng	0
瓯北医院	ou'bei'yi'yuan	0
瓯北邮政局	ou'bei'you'zheng'ju	0
鸥陂渔话	ou'bei'yu'hua	0
偶被豫且制	ou'bei'yu'qie'zhi	0
瓯北真	ou'bei'zhen	0
瓯北镇	ou'bei'zhen	0
瓯北镇府	ou'bei'zhen'fu	0
瓯北镇政府	ou'bei'zhen'zheng'fu	0
偶被主人留	ou'bei'zhu'ren'liu	0
欧本	ou'ben	0
歐本	ou'ben	0
欧本咖	ou'ben'ka	0
欧本咖啡	ou'ben'ka'fei	0
欧本外贸服饰	ou'ben'wai'mao'fu'shi	0
欧比	ou'bi	0
欧碧	ou'bi	0
欧必达	ou'bi'da	0
欧必达大酒店	ou'bi'da'da'jiu'dian	0
欧比迪斯	ou'bi'di'si	0
欧比尔蝙蝠	ou'bi'er'bian'fu	0
欧碧倩	ou'bi'qian	0
欧碧荃	ou'bi'quan	0
欧比十欠	ou'bi'shi'qian	0
欧比斯	ou'bi'si	0
欧比斯的潘多兰盖伦	ou'bi'si'de'pan'duo'lan'gai'lun	0
欧比斯的相关知识	ou'bi'si'de'xiang'guan'zhi'shi	0
欧比斯迪	ou'bi'si'di	0
欧比斯迪的鳞片	ou'bi'si'di'de'lin'pian	0
欧比斯迪的卵正在打开	ou'bi'si'di'de'luan'zheng'zai'da'kai	0
欧比斯迪栖木	ou'bi'si'di'qi'mu	0
欧比斯点数	ou'bi'si'dian'shu	0
欧比斯粉末	ou'bi'si'fen'mo	0
欧比斯基础教育	ou'bi'si'ji'chu'jiao'yu	0
欧比斯纪念品	ou'bi'si'ji'nian'pin	0
欧比斯疾走	ou'bi'si'ji'zou	0
欧比斯入场任务	ou'bi'si'ru'chang'ren'wu	0
欧比斯用路灯补给	ou'bi'si'yong'lu'deng'bu'gei	0
欧比斯战斗教育	ou'bi'si'zhan'dou'jiao'yu	0
欧比特	ou'bi'te	0
欧必亭	ou'bi'ting	0
欧比旺	ou'bi'wang	0
欧比旺克诺比	ou'bi'wang'ke'nuo'bi	0
欧比旺肯诺比	ou'bi'wang'ken'nuo'bi	0
欧碧玺	ou'bi'xi	0
欧边	ou'bian	0
欧鳊	ou'bian	0
欧边村	ou'bian'cun	0
呕变反肠出	ou'bian'fan'chang'chu	0
鸥边可泊舟	ou'bian'ke'bo'zhou	0
鸥边水叶开	ou'bian'shui'ye'kai	0
偶变投隙	ou'bian'tou'xi	0
藕扁叶蜂属	ou'bian'ye'feng'shu	0
鸥边野水水边屋	ou'bian'ye'shui'shui'bian'wu	0
欧标	ou'biao	0
偶别十年成瞬息	ou'bie'shi'nian'cheng'shun'xi	0
欧彬	ou'bin	0
藕饼	ou'bing	0
欧博	ou'bo	0
欧帛	ou'bo	0
欧泊	ou'bo	0
欧波	ou'bo	0
欧博城	ou'bo'cheng	0
沤波村	ou'bo'cun	0
欧伯达	ou'bo'da	0
欧泊德	ou'bo'de	0
欧薄荷	ou'bo'he	0
欧泊戒指	ou'bo'jie'zhi	0
欧博莱	ou'bo'lai	0
欧泊莱	ou'bo'lai	0
欧泊兰	ou'bo'lan	0
欧波朗	ou'bo'lang	0
欧伯麟	ou'bo'lin	0
欧柏林	ou'bo'lin	0
欧柏林大学	ou'bo'lin'da'xue	0
沤钵罗	ou'bo'luo	0
欧波罗高层公寓	ou'bo'luo'gao'ceng'gong'yu	0
瓯钵罗室书画过目考	ou'bo'luo'shi'shu'hua'guo'mu'kao	0
偶泊鸣蝉岛	ou'bo'ming'chan'dao	0
欧波摩珀	ou'bo'mo'po	0
欧博诺	ou'bo'nuo	0
鸥波萍迹	ou'bo'ping'ji	0
欧波僧正	ou'bo'seng'zheng	0
欧泊圣堡	ou'bo'sheng'bao	0
欧博圣堡酒庄	ou'bo'sheng'bao'jiu'zhuang	0
偶泊石	ou'bo'shi	0
欧泊石	ou'bo'shi	0
欧博士护唇膏	ou'bo'shi'hu'chun'gao	0
欧博士小儿止咳露	ou'bo'shi'xiao'er'zhi'ke'lu	0
欧博士止咳露	ou'bo'shi'zhi'ke'lu	0
欧博特	ou'bo'te	0
欧博特地板	ou'bo'te'di'ban	0
欧博信	ou'bo'xin	0
欧博雅	ou'bo'ya	0
沤波耶波罗蜜	ou'bo'ye'bo'luo'mi	0
欧布	ou'bu	0
欧不不不	ou'bu'bu'bu	0
欧布尔	ou'bu'er	0
欧布拉	ou'bu'la	0
欧布里德	ou'bu'li'de	0
欧布洛贝尔	ou'bu'luo'bei'er	0
偶不明白	ou'bu'ming'bai	0
呕不能食	ou'bu'neng'shi	0
呕不能食急煎尝	ou'bu'neng'shi'ji'jian'chang	0
呕不能饮食	ou'bu'neng'yin'shi	0
偶不平衡	ou'bu'ping'heng	0
鸥不起	ou'bu'qi	0
欧不去	ou'bu'qu	0
偶不上学	ou'bu'shang'xue	0
偶不说话	ou'bu'shuo'hua	0
欧布头	ou'bu'tou	0
偶不陨中路	ou'bu'yun'zhong'lu	0
呕不止	ou'bu'zhi	0
欧才	ou'cai	0
欧菜	ou'cai	0
沤菜	ou'cai	0
欧彩徽	ou'cai'hui	0
欧菜坪	ou'cai'ping	0
欧参宝	ou'can'bao	0
欧仓	ou'cang	0
藕草听批颊	ou'cao'ting'pi'jia	0
偶册那	ou'ce'na	0
偶曾先后掌丝纶	ou'ceng'xian'hou'zhang'si'lun	0
欧差	ou'cha	0
欧查	ou'cha	0
欧查果	ou'cha'guo	0
欧查军	ou'cha'jun	0
欧查之剑	ou'cha'zhi'jian	0
偶产生	ou'chan'sheng	0
欧畅	ou'chang	0
瓯昌	ou'chang	0
瓯昌饭店	ou'chang'fan'dian	0
欧潮	ou'chao	0
藕炒豆芽	ou'chao'dou'ya	0
欧潮饭	ou'chao'fan	0
欧潮饭庄	ou'chao'fan'zhuang	0
欧车	ou'che	0
欧车前亲水胶	ou'che'qian'qin'shui'jiao	0
欧车前亲水胶干混悬剂	ou'che'qian'qin'shui'jiao'gan'hun'xuan'ji	0
欧车前亲水胶散剂	ou'che'qian'qin'shui'jiao'san'ji	0
欧辰帆	ou'chen'fan	0
偶陈幕中画	ou'chen'mu'zhong'hua	0
偶成	ou'cheng	0
欧城	ou'cheng	0
瓯城	ou'cheng	0
偶成此词	ou'cheng'ci'ci	0
偶成二老风流事	ou'cheng'er'lao'feng'liu'shi	0
偶成二首	ou'cheng'er'shou	0
偶乘风有韵	ou'cheng'feng'you'yun	0
瓯城花苑	ou'cheng'hua'yuan	0
偶乘黄犊出	ou'cheng'huang'du'chu	0
偶成江东游	ou'cheng'jiang'dong'you	0
偶成聊近意	ou'cheng'liao'jin'yi	0
偶成卯时醉	ou'cheng'mao'shi'zui	0
偶乘青雀舫	ou'cheng'qing'que'fang	0
偶成三日寒兼热	ou'cheng'san'ri'han'jian're	0
偶成诗句长哦罢	ou'cheng'shi'ju'chang'o'ba	0
偶成投秘简	ou'cheng'tou'mi'jian	0
偶成一朝荣	ou'cheng'yi'zhao'rong	0
偶呈郑先辈	ou'cheng'zheng'xian'bei	0
藕池	ou'chi	0
藕池村	ou'chi'cun	0
藕池大厦	ou'chi'da'sha	0
藕池河	ou'chi'he	0
藕池路	ou'chi'lu	0
欧吃矛	ou'chi'mao	0
藕池任村	ou'chi'ren'cun	0
藕池头	ou'chi'tou	0
藕池卫生院	ou'chi'wei'sheng'yuan	0
藕池巷	ou'chi'xiang	0
藕池小学	ou'chi'xiao'xue	0
藕池新村	ou'chi'xin'cun	0
偶持一竿竹	ou'chi'yi'gan'zhu	0
藕池站	ou'chi'zhan	0
藕池镇	ou'chi'zhen	0
欧冲	ou'chong	0
藕冲	ou'chong	0
欧冲村	ou'chong'cun	0
欧冲山	ou'chong'shan	0
欧充舒	ou'chong'shu	0
呕臭	ou'chou	0
欧处	ou'chu	0
偶出滴	ou'chu'di	0
殴除付疲兵	ou'chu'fu'pi'bing	0
欧楚坚	ou'chu'jian	0
欧楚君	ou'chu'jun	0
欧楚朗	ou'chu'lang	0
区楚良	ou'chu'liang	0
偶出山来得半闲	ou'chu'shan'lai'de'ban'xian	0
偶出西湖上	ou'chu'xi'hu'shang	0
呕出心肝	ou'chu'xin'gan	0
偶除须鬓著袈裟	ou'chu'xu'bin'zhu'jia'sha	0
藕船题跋	ou'chuan'ti'ba	0
欧纯	ou'chun	0
偶次	ou'ci	0
偶此成宾主	ou'ci'cheng'bin'zhu	0
偶次畸变率	ou'ci'ji'bian'lv	0
偶此琳宫居	ou'ci'lin'gong'ju	0
偶此惬真性	ou'ci'qie'zhen'xing	0
偶次谐波	ou'ci'xie'bo	0
偶此延朝昏	ou'ci'yan'chao'hun	0
偶刺者	ou'ci'zhe	0
偶从禅老得真趣	ou'cong'chan'lao'de'zhen'qu	0
偶从池上醉	ou'cong'chi'shang'zui	0
偶从二三子	ou'cong'er'san'zi	0
偶従二三子	ou'cong'er'san'zi	0
偶从桂树招	ou'cong'gui'shu'zhao	0
偶从谏官列	ou'cong'jian'guan'lie	0
偶从山后到山前	ou'cong'shan'hou'dao'shan'qian	0
偶从越女笑	ou'cong'yue'nv'xiao	0
偶従越女笑	ou'cong'yue'nv'xiao	0
欧翠	ou'cui	0
欧萃碧	ou'cui'bi	0
欧翠芬	ou'cui'fen	0
藕脆削琼英	ou'cui'xue'qiong'ying	0
偶村	ou'cun	0
欧村	ou'cun	0
讴村	ou'cun	0
鸥村	ou'cun	0
偶存夹杂	ou'cun'jia'za	0
偶存名迹在人间	ou'cun'ming'ji'zai'ren'jian	0
偶存元素	ou'cun'yuan'su	0
偶存元索	ou'cun'yuan'suo	0
偶存杂质	ou'cun'za'zhi	0
欧厝	ou'cuo	0
欧厝村	ou'cuo'cun	0
欧达	ou'da	0
殴打	ou'da	0
殴打比丘与拟打	ou'da'bi'qiu'yu'ni'da	0
殴打等暴力行为	ou'da'deng'bao'li'xing'wei	0
欧达辉	ou'da'hui	0
欧达可	ou'da'ke	0
殴打虐待致伤致死赔偿	ou'da'nve'dai'zhi'shang'zhi'si'pei'chang	0
殴打虐待致伤致死赔偿	ou'da'nve'dai'zhi'shang'zhi'si'pei'chang	0
欧大任	ou'da'ren	0
欧大山	ou'da'shan	0
殴打他人	ou'da'ta'ren	0
欧达铜镍合金	ou'da'tong'nie'he'jin	0
殴打小盆友	ou'da'xiao'pen'you	0
殴打诱发者	ou'da'you'fa'zhe	0
殴打有志穷青年	ou'da'you'zhi'qiong'qing'nian	0
藕带	ou'dai	0
欧黛儿	ou'dai'er	0
欧黛学院	ou'dai'xue'yuan	0
欧黛学院紧急传送点	ou'dai'xue'yuan'jin'ji'chuan'song'dian	0
偶氮	ou'dan	0
欧单	ou'dan	0
欧旦	ou'dan	0
偶氮苯	ou'dan'ben	0
偶氮苯磺酸	ou'dan'ben'huang'suan	0
偶氮苯羧酸	ou'dan'ben'suo'suan	0
偶氮蛋白	ou'dan'dan'bai	0
偶氮蛋白质	ou'dan'dan'bai'zhi	0
偶氮胆红素	ou'dan'dan'hong'su	0
欧丹多富梨寺	ou'dan'duo'fu'li'si	0
偶氮二异丁腈	ou'dan'er'yi'ding'jing	0
偶氮二异丁氰	ou'dan'er'yi'ding'qing	0
偶氮二异庚腈	ou'dan'er'yi'geng'jing	0
偶氮骨胶原	ou'dan'gu'jiao'yuan	0
偶氮化合物	ou'dan'hua'he'wu	0
偶氮黄	ou'dan'huang	0
偶氮黄二钠盐	ou'dan'huang'er'na'yan	0
偶氮黄四钠盐	ou'dan'huang'si'na'yan	0
偶氮基	ou'dan'ji	0
偶氮甲碱	ou'dan'jia'jian	0
偶氮甲酰胺	ou'dan'jia'xian'an	0
偶氮桔梗	ou'dan'jie'geng	0
偶氮酷蛋白	ou'dan'ku'dan'bai	0
偶氮蓝	ou'dan'lan	0
偶氮酪蛋白	ou'dan'lao'dan'bai	0
偶氮氯膦	ou'dan'lv'lin	0
偶氮品红	ou'dan'pin'hong	0
偶氮染料	ou'dan'ran'liao	0
偶氮染色法	ou'dan'ran'se'fa	0
偶氮砷	ou'dan'shen	0
偶氮胂	ou'dan'shen	0
偶氮胂钯	ou'dan'shen'ba	0
偶氮羧	ou'dan'suo	0
偶氮胭脂红	ou'dan'yan'zhi'hong	0
偶氮洋红	ou'dan'yang'hong	0
偶氮氧化偶氮	ou'dan'yang'hua'ou'dan	0
偶氮荧光桃红	ou'dan'ying'guang'tao'hong	0
偶氮玉红	ou'dan'yu'hong	0
偶氮紫	ou'dan'zi	0
偶当谷贱岁	ou'dang'gu'jian'sui	0
欧当归	ou'dang'gui	0
欧当归属	ou'dang'gui'shu	0
欧宕里	ou'dang'li	0
呕到	ou'dao	0
欧刀	ou'dao	0
欧岛	ou'dao	0
偶到初迷路	ou'dao'chu'mi'lu	0
偶到湖光里	ou'dao'hu'guang'li	0
欧岛咖	ou'dao'ka	0
欧岛咖啡	ou'dao'ka'fei	0
呕到了	ou'dao'le	0
偶到临分处	ou'dao'lin'fen'chu	0
偶到溪头晴唤出	ou'dao'xi'tou'qing'huan'chu	0
欧稻智	ou'dao'zhi	0
偶德	ou'de	0
偶的	ou'de	0
欧得	ou'de	0
欧德	ou'de	0
欧的	ou'de	0
欧德堡	ou'de'bao	0
欧德宝	ou'de'bao	0
欧德宝奶油	ou'de'bao'nai'you	0
偶的产生	ou'de'chan'sheng	0
欧德诚	ou'de'cheng	0
偶得儿曹文字林	ou'de'er'cao'wen'zi'lin	0
偶的发完	ou'de'fa'wan	0
欧德菲尔德	ou'de'fei'er'de	0
欧德福	ou'de'fu	0
藕的很	ou'de'hen	0
欧德教堂	ou'de'jiao'tang	0
欧德劳的永行长靴	ou'de'lao'de'yong'xing'chang'xue	0
欧得利	ou'de'li	0
欧的俪	ou'de'li	0
欧的俪雪	ou'de'li'xue	0
欧的俪雪糕屋	ou'de'li'xue'gao'wu	0
欧德林	ou'de'lin	0
欧德隆	ou'de'long	0
欧德龙	ou'de'long	0
欧德龙餐厅	ou'de'long'can'ting	0
欧德隆淄	ou'de'long'zi	0
欧德隆淄博店	ou'de'long'zi'bo'dian	0
欧德鲁朗	ou'de'lu'lang	0
欧德麦	ou'de'mai	0
欧得曼	ou'de'man	0
偶得冥心理	ou'de'ming'xin'li	0
欧德宁	ou'de'ning	0
欧德仕	ou'de'shi	0
欧得斯月球灯	ou'de'si'yue'qiu'deng	0
偶得凶丑降	ou'de'xiong'chou'jiang	0
欧得洋	ou'de'yang	0
偶得幽闲境	ou'de'you'xian'jing	0
偶得鱼鸟趣	ou'de'yu'niao'qu	0
欧登	ou'deng	0
欧邓	ou'deng	0
欧登柏格	ou'deng'bai'ge	0
欧登保龄球馆	ou'deng'bao'ling'qiu'guan	0
欧登贝格	ou'deng'bei'ge	0
欧邓村	ou'deng'cun	0
欧登咖啡	ou'deng'ka'fei	0
欧登索夫	ou'deng'suo'fu	0
偶滴	ou'di	0
欧地	ou'di	0
欧底	ou'di	0
欧弟	ou'di	0
欧迪	ou'di	0
殴迪	ou'di	0
鸥迪	ou'di	0
欧迪办公	ou'di'ban'gong	0
欧迪贝	ou'di'bei	0
欧迪贝吡格列酮	ou'di'bei'bi'ge'lie'tong	0
欧迪比欧	ou'di'bi'ou	0
欧迪博	ou'di'bo	0
欧迪波士	ou'di'bo'shi	0
欧帝厂	ou'di'chang	0
欧迪橱柜	ou'di'chu'gui	0
欧迪大酒店	ou'di'da'jiu'dian	0
欧迪电器	ou'di'dian'qi	0
欧帝尔	ou'di'er	0
欧迪芬	ou'di'fen	0
欧迪芬成品仓	ou'di'fen'cheng'pin'cang	0
欧蒂芙	ou'di'fu	0
欧蒂化妆品	ou'di'hua'zhuang'pin	0
欧迪佳	ou'di'jia	0
欧迪佳片	ou'di'jia'pian	0
欧帝咖啡	ou'di'ka'fei	0
欧迪咖啡	ou'di'ka'fei	0
欧迪克	ou'di'ke	0
欧迪乐	ou'di'le	0
欧迪里斯	ou'di'li'si	0
欧迪良子	ou'di'liang'zi	0
欧迪玛	ou'di'ma	0
欧迪姆	ou'di'mu	0
欧迪普	ou'di'pu	0
偶滴神啊	ou'di'shen'a	0
欧狄氏括约肌痉挛	ou'di'shi'kuo'yue'ji'jing'luan	0
欧地西克居委会	ou'di'xi'ke'ju'wei'hui	0
欧蒂香水吧	ou'di'xiang'shui'ba	0
欧迪亚	ou'di'ya	0
欧典	ou'dian	0
欧店	ou'dian	0
欧点	ou'dian	0
欧典橱柜	ou'dian'chu'gui	0
欧店村	ou'dian'cun	0
欧典地板	ou'dian'di'ban	0
欧典风格四件套	ou'dian'feng'ge'si'jian'tao	0
欧典风尚长枕套	ou'dian'feng'shang'chang'zhen'tao	0
欧典风尚床盖四件套	ou'dian'feng'shang'chuang'gai'si'jian'tao	0
欧典花园	ou'dian'hua'yuan	0
欧典家具	ou'dian'jia'ju	0
欧典家居	ou'dian'jia'ju	0
欧典家园	ou'dian'jia'yuan	0
偶点卡	ou'dian'ka	0
欧典咖	ou'dian'ka	0
欧典咖啡	ou'dian'ka'fei	0
欧典咖啡美食	ou'dian'ka'fei'mei'shi	0
欧典咖啡厅	ou'dian'ka'fei'ting	0
欧典咖啡屋	ou'dian'ka'fei'wu	0
欧典纳	ou'dian'na	0
欧典琴行	ou'dian'qin'hang	0
欧典商苑	ou'dian'shang'yuan	0
欧典圣华	ou'dian'sheng'hua	0
欧典时尚	ou'dian'shi'shang	0
欧典水乡	ou'dian'shui'xiang	0
欧典语	ou'dian'yu	0
欧典语茶	ou'dian'yu'cha	0
欧典玉组	ou'dian'yu'zu	0
欧吊	ou'diao	0
欧蝶电动车	ou'die'dian'dong'che	0
欧蝶九件套	ou'die'jiu'jian'tao	0
欧丁	ou'ding	0
欧订	ou'ding	0
欧顶	ou'ding	0
藕丁	ou'ding	0
欧定福	ou'ding'fu	0
欧丁弄蝶属	ou'ding'nong'die'shu	0
欧丁香	ou'ding'xiang	0
欧定兴	ou'ding'xing	0
偶洞	ou'dong	0
欧东	ou'dong	0
欧洞	ou'dong	0
藕洞	ou'dong	0
欧冻赤松球蚜	ou'dong'chi'song'qiu'ya	0
欧东村	ou'dong'cun	0
偶动画	ou'dong'hua	0
欧东坞	ou'dong'wu	0
欧洞乡	ou'dong'xiang	0
偶逗	ou'dou	0
欧都	ou'dou	0
偶都看到	ou'dou'kan'dao	0
欧都蕾	ou'dou'lei	0
欧都蕾苏	ou'dou'lei'su	0
欧兜迈	ou'dou'mai	0
欧兜迈环台日记	ou'dou'mai'huan'tai'ri'ji	0
欧都纳	ou'dou'na	0
欧度	ou'du	0
欧渡	ou'du	0
偶度白云片	ou'du'bai'yun'pian	0
欧杜毒针	ou'du'du'zhen	0
欧杜尔	ou'du'er	0
欧度服饰	ou'du'fu'shi	0
欧度鲁老兵	ou'du'lu'lao'bing	0
欧督男装	ou'du'nan'zhuang	0
欧度男装官方旗舰店正品专柜	ou'du'nan'zhuang'guan'fang'qi'jian'dian'zheng'pin'zhuan'gui	0
偶睹犬与鸢	ou'du'quan'yu'yuan	0
藕断	ou'duan	0
欧段励	ou'duan'li	0
藕断丝长	ou'duan'si'chang	0
藕断丝联	ou'duan'si'lian	0
藕断丝连	ou'duan'si'lian	0
藕断丝牵	ou'duan'si'qian	0
欧椴瘿蚊	ou'duan'ying'wen	0
偶对先生尽一樽	ou'dui'xian'sheng'jin'yi'zun	0
欧顿	ou'dun	0
呕多	ou'duo	0
欧多	ou'duo	0
欧多迪特	ou'duo'di'te	0
欧多多	ou'duo'duo	0
藕多多	ou'duo'duo	0
欧朵莉	ou'duo'li	0
偶夺骊龙颔下珠	ou'duo'li'long'han'xia'zhu	0
沤多罗僧	ou'duo'luo'seng	0
欧多态毛蚜	ou'duo'tai'mao'ya	0
呕多沃沫	ou'duo'wo'mo	0
欧蛾科	ou'e'ke	0
欧恩	ou'en	0
欧儿	ou'er	0
欧尔	ou'er	0
偶尔爱我的人	ou'er'ai'wo'de'ren	0
呕而肠鸣	ou'er'chang'ming	0
欧尔达	ou'er'da	0
欧尔达霍伊拉村委会	ou'er'da'huo'yi'la'cun'wei'hui	0
欧尔达库勒村委会	ou'er'da'ku'le'cun'wei'hui	0
欧尔大木麻札	ou'er'da'mu'ma'zha	0
欧尔达特	ou'er'da'te	0
欧尔达吾达吾斯塘村委会	ou'er'da'wu'da'wu'si'tang'cun'wei'hui	0
偶尔的抽	ou'er'de'chou	0
偶尔的能力者	ou'er'de'neng'li'zhe	0
偶尔的失眠	ou'er'de'shi'mian	0
偶尔的痒	ou'er'de'yang	0
欧尔迪恩	ou'er'di'en	0
欧尔杜因	ou'er'du'yin	0
欧尔法赫埃霍尔	ou'er'fa'he'ai'huo'er	0
呕而发热者	ou'er'fa're'zhe	0
呕而发热者小柴胡汤主之	ou'er'fa're'zhe'xiao'chai'hu'tang'zhu'zhi	0
欧尔符文	ou'er'fu'wen	0
欧儿高纤麦麸饼	ou'er'gao'xian'mai'fu'bing	0
欧儿高纤燕麦杂锦饼	ou'er'gao'xian'yan'mai'za'jin'bing	0
耦而耕	ou'er'geng	0
欧尔冠台	ou'er'guan'tai	0
偶尔过去看看你	ou'er'guo'qu'kan'kan'ni	0
欧尔哈尔多	ou'er'ha'er'duo	0
欧尔海胆籽寿司	ou'er'hai'dan'zi'shou'si	0
呕而汗出	ou'er'han'chu	0
偶尔和姐姐	ou'er'he'jie'jie	0
欧儿花生酥	ou'er'hua'sheng'su	0
偶尔坏坏	ou'er'huai'huai	0
欧尔皇家驳船	ou'er'huang'jia'bo'chuan	0
偶尔会吃醋	ou'er'hui'chi'cu	0
欧尔佳	ou'er'jia	0
欧儿加盖燕麦杂锦饼	ou'er'jia'gai'yan'mai'za'jin'bing	0
欧儿坚果燕麦饼	ou'er'jian'guo'yan'mai'bing	0
偶尔见奇处	ou'er'jian'qi'chu	0
欧儿九谷全麦饼	ou'er'jiu'gu'quan'mai'bing	0
欧尔卡特	ou'er'ka'te	0
呕而咳	ou'er'ke	0
偶尔拉疯	ou'er'la'feng	0
偶尔来江上	ou'er'lai'jiang'shang	0
偶尔来中州	ou'er'lai'zhong'zhou	0
欧儿粒粒巧克力松饼	ou'er'li'li'qiao'ke'li'song'bing	0
欧尔莉亚	ou'er'li'ya	0
偶尔聊个天	ou'er'liao'ge'tian	0
欧尔烈格	ou'er'lie'ge	0
偶尔留连借馀景	ou'er'liu'lian'jie'yu'jing	0
欧尔洛克	ou'er'luo'ke	0
欧尔洛斯塔	ou'er'luo'si'ta	0
呕而脉弱	ou'er'mai'ruo	0
欧尔瑁	ou'er'mao	0
呕而密默	ou'er'mi'mo	0
欧儿迷你牛油松饼	ou'er'mi'ni'niu'you'song'bing	0
欧儿迷你巧克力松饼	ou'er'mi'ni'qiao'ke'li'song'bing	0
欧儿巧克力酱夹心饼	ou'er'qiao'ke'li'jiang'jia'xin'bing	0
藕二人也到了	ou'er'ren'ye'dao'le	0
欧儿三果全麦饼	ou'er'san'guo'quan'mai'bing	0
欧儿三星葱蛋卷	ou'er'san'xing'cong'dan'juan	0
欧尔桑克	ou'er'sang'ke	0
欧尔桑克晶石	ou'er'sang'ke'jing'shi	0
欧尔桑克树园	ou'er'sang'ke'shu'yuan	0
欧尔说书人	ou'er'shuo'shu'ren	0
偶尔送	ou'er'song	0
欧儿碎巧克力牛油饼	ou'er'sui'qiao'ke'li'niu'you'bing	0
欧儿提子牛油味松饼	ou'er'ti'zi'niu'you'wei'song'bing	0
偶尔听到你的催促	ou'er'ting'dao'ni'de'cui'cu	0
欧尔瓦	ou'er'wa	0
欧儿豌豆酥	ou'er'wan'dou'su	0
欧尔亡灵小鸡	ou'er'wang'ling'xiao'ji	0
欧尔威	ou'er'wei	0
偶尔我轻咳一声	ou'er'wo'qing'ke'yi'sheng	0
欧儿五谷麦麸饼	ou'er'wu'gu'mai'fu'bing	0
欧儿无糖全麦饼	ou'er'wu'tang'quan'mai'bing	0
偶尔无意	ou'er'wu'yi	0
偶尔相处	ou'er'xiang'chu	0
欧儿香蕉蛋卷	ou'er'xiang'jiao'dan'juan	0
欧儿香芋酥	ou'er'xiang'yu'su	0
偶尔心情感冒发烧	ou'er'xin'qing'gan'mao'fa'shao	0
偶尔性	ou'er'xing	0
呕而胸满者	ou'er'xiong'man'zhe	0
偶尔寻梅去	ou'er'xun'mei'qu	0
欧尔雅	ou'er'ya	0
欧尔雅家私	ou'er'ya'jia'si	0
欧儿燕麦芝麻松饼	ou'er'yan'mai'zhi'ma'song'bing	0
欧儿意大利香浓蜂蜜什锦糖橙	ou'er'yi'da'li'xiang'nong'feng'mi'shi'jin'tang'cheng	0
欧儿意大利香浓蜂蜜什锦糖红	ou'er'yi'da'li'xiang'nong'feng'mi'shi'jin'tang'hong	0
欧尔遗迹	ou'er'yi'ji	0
偶而应之	ou'er'ying'zhi	0
偶尔有历史美术馆	ou'er'you'li'shi'mei'shu'guan	0
欧尔怨灵	ou'er'yuan'ling	0
欧儿杂锦夹心饼干	ou'er'za'jin'jia'xin'bing'gan	0
偶尔在情绪会泛滥的夜	ou'er'zai'qing'xu'hui'fan'lan'de'ye	0
欧儿早餐麦片饼	ou'er'zao'can'mai'pian'bing	0
欧尔之泪	ou'er'zhi'lei	0
欧儿芝士酥	ou'er'zhi'shi'su	0
欧儿紫菜蛋卷	ou'er'zi'cai'dan'juan	0
偶尔自发痛	ou'er'zi'fa'tong	0
偶发	ou'fa	0
偶发代谢	ou'fa'dai'xie	0
偶发电离	ou'fa'dian'li	0
偶发犯	ou'fa'fan	0
偶发房室性期外收缩	ou'fa'fang'shi'xing'qi'wai'shou'suo	0
偶发分支杆菌感染	ou'fa'fen'zhi'gan'jun'gan'ran	0
偶发故障	ou'fa'gu'zhang	0
偶发狂言惊满坐	ou'fa'kuang'yan'jing'man'zuo	0
偶发区	ou'fa'qu	0
偶发事件	ou'fa'shi'jian	0
偶发性的大发生	ou'fa'xing'de'da'fa'sheng	0
偶发性交通拥挤	ou'fa'xing'jiao'tong'yong'ji	0
偶发杂交	ou'fa'za'jiao	0
偶犯	ou'fan	0
瓯泛茶如乳	ou'fan'cha'ru'ru	0
欧范儿	ou'fan'er	0
欧梵诺	ou'fan'nuo	0
瓯饭瓢饮	ou'fan'piao'yin	0
鸥泛已春声	ou'fan'yi'chun'sheng	0
欧坊	ou'fang	0
欧防	ou'fang	0
欧纺布艺	ou'fang'bu'yi	0
欧防风	ou'fang'feng	0
欧防风属	ou'fang'feng'shu	0
偶访金仙道	ou'fang'jin'xian'dao	0
欧房楠	ou'fang'nan	0
欧啡	ou'fei	0
欧废	ou'fei	0
欧菲	ou'fei	0
沤肥	ou'fei	0
瓯飞	ou'fei	0
欧菲尔	ou'fei'er	0
欧菲尔姿女校	ou'fei'er'zi'nv'xiao	0
欧菲光	ou'fei'guang	0
欧菲科技	ou'fei'ke'ji	0
欧菲莱诗	ou'fei'lai'shi	0
欧菲莱斯	ou'fei'lai'si	0
欧菲莉雅	ou'fei'li'ya	0
欧啡思	ou'fei'si	0
欧啡思北	ou'fei'si'bei	0
欧飞雄	ou'fei'xiong	0
欧菲亚	ou'fei'ya	0
藕粉	ou'fen	0
藕粉长裙	ou'fen'chang'qun	0
藕粉桂糖糕	ou'fen'gui'tang'gao	0
藕粉雪汤圆	ou'fen'xue'tang'yuan	0
欧粉一号	ou'fen'yi'hao	0
藕粉圆子	ou'fen'yuan'zi	0
欧风	ou'feng	0
偶逢白堕争春手	ou'feng'bai'duo'zheng'chun'shou	0
欧风玻砖	ou'feng'bo'zhuan	0
偶逢菜叶随流水	ou'feng'cai'ye'sui'liu'shui	0
欧风衬衣	ou'feng'chen'yi	0
欧风城	ou'feng'cheng	0
偶逢池竹处	ou'feng'chi'zhu'chu	0
欧风床裙四件套	ou'feng'chuang'qun'si'jian'tao	0
欧风纯棉四件套	ou'feng'chun'mian'si'jian'tao	0
欧风纯棉四件套爱的寓意	ou'feng'chun'mian'si'jian'tao'ai'de'yu'yi	0
欧风纯棉四件套纯正优雅	ou'feng'chun'mian'si'jian'tao'chun'zheng'you'ya	0
欧风纯棉四件套大红玫瑰誓言	ou'feng'chun'mian'si'jian'tao'da'hong'mei'gui'shi'yan	0
欧风纯棉四件套帝诺情怀	ou'feng'chun'mian'si'jian'tao'di'nuo'qing'huai	0
欧风纯棉四件套典雅玫瑰	ou'feng'chun'mian'si'jian'tao'dian'ya'mei'gui	0
欧风纯棉四件套都市精灵	ou'feng'chun'mian'si'jian'tao'du'shi'jing'ling	0
欧风纯棉四件套粉	ou'feng'chun'mian'si'jian'tao'fen	0
欧风纯棉四件套红	ou'feng'chun'mian'si'jian'tao'hong	0
欧风纯棉四件套花间小栖粉	ou'feng'chun'mian'si'jian'tao'hua'jian'xiao'qi'fen	0
欧风纯棉四件套花间小栖蓝	ou'feng'chun'mian'si'jian'tao'hua'jian'xiao'qi'lan	0
欧风纯棉四件套花妍风韵	ou'feng'chun'mian'si'jian'tao'hua'yan'feng'yun	0
欧风纯棉四件套花雨朦胧	ou'feng'chun'mian'si'jian'tao'hua'yu'meng'long	0
欧风纯棉四件套花语沁春红	ou'feng'chun'mian'si'jian'tao'hua'yu'qin'chun'hong	0
欧风纯棉四件套花语沁春蓝	ou'feng'chun'mian'si'jian'tao'hua'yu'qin'chun'lan	0
欧风纯棉四件套欢乐祝福	ou'feng'chun'mian'si'jian'tao'huan'le'zhu'fu	0
欧风纯棉四件套简约都市	ou'feng'chun'mian'si'jian'tao'jian'yue'du'shi	0
欧风纯棉四件套镜花缘红	ou'feng'chun'mian'si'jian'tao'jing'hua'yuan'hong	0
欧风纯棉四件套镜花缘紫	ou'feng'chun'mian'si'jian'tao'jing'hua'yuan'zi	0
欧风纯棉四件套蓝	ou'feng'chun'mian'si'jian'tao'lan	0
欧风纯棉四件套蓝调生活	ou'feng'chun'mian'si'jian'tao'lan'diao'sheng'huo	0
欧风纯棉四件套浪漫格调	ou'feng'chun'mian'si'jian'tao'lang'man'ge'diao	0
欧风纯棉四件套律动咖啡	ou'feng'chun'mian'si'jian'tao'lv'dong'ka'fei	0
欧风纯棉四件套绿光森林	ou'feng'chun'mian'si'jian'tao'lv'guang'sen'lin	0
欧风纯棉四件套梦里花香	ou'feng'chun'mian'si'jian'tao'meng'li'hua'xiang	0
欧风纯棉四件套霓裳花羽	ou'feng'chun'mian'si'jian'tao'ni'chang'hua'yu	0
欧风纯棉四件套浓请玫瑰	ou'feng'chun'mian'si'jian'tao'nong'qing'mei'gui	0
欧风纯棉四件套欧风时尚	ou'feng'chun'mian'si'jian'tao'ou'feng'shi'shang	0
欧风纯棉四件套品味生活	ou'feng'chun'mian'si'jian'tao'pin'wei'sheng'huo	0
欧风纯棉四件套倾城佳人	ou'feng'chun'mian'si'jian'tao'qing'cheng'jia'ren	0
欧风纯棉四件套清风似梦	ou'feng'chun'mian'si'jian'tao'qing'feng'si'meng	0
欧风纯棉四件套情感基调	ou'feng'chun'mian'si'jian'tao'qing'gan'ji'diao	0
欧风纯棉四件套清香	ou'feng'chun'mian'si'jian'tao'qing'xiang	0
欧风纯棉四件套身临其境	ou'feng'chun'mian'si'jian'tao'shen'lin'qi'jing	0
欧风纯棉四件套世纪之恋	ou'feng'chun'mian'si'jian'tao'shi'ji'zhi'lian	0
欧风纯棉四件套水灵佳人	ou'feng'chun'mian'si'jian'tao'shui'ling'jia'ren	0
欧风纯棉四件套陶醉	ou'feng'chun'mian'si'jian'tao'tao'zui	0
欧风纯棉四件套温馨家园	ou'feng'chun'mian'si'jian'tao'wen'xin'jia'yuan	0
欧风纯棉四件套夏花的森林	ou'feng'chun'mian'si'jian'tao'xia'hua'de'sen'lin	0
欧风纯棉四件套香奈儿黄	ou'feng'chun'mian'si'jian'tao'xiang'nai'er'huang	0
欧风纯棉四件套向阳花开	ou'feng'chun'mian'si'jian'tao'xiang'yang'hua'kai	0
欧风纯棉四件套小象帕特黄	ou'feng'chun'mian'si'jian'tao'xiao'xiang'pa'te'huang	0
欧风纯棉四件套小小爱乐园	ou'feng'chun'mian'si'jian'tao'xiao'xiao'ai'le'yuan	0
欧风纯棉四件套心悦玫瑰	ou'feng'chun'mian'si'jian'tao'xin'yue'mei'gui	0
欧风纯棉四件套幸福时光	ou'feng'chun'mian'si'jian'tao'xing'fu'shi'guang	0
欧风纯棉四件套雅致心语	ou'feng'chun'mian'si'jian'tao'ya'zhi'xin'yu	0
欧风纯棉四件套怡情叶姿	ou'feng'chun'mian'si'jian'tao'yi'qing'ye'zi	0
欧风纯棉四件套茵茵花香	ou'feng'chun'mian'si'jian'tao'yin'yin'hua'xiang	0
欧风纯棉四件套永恒经典	ou'feng'chun'mian'si'jian'tao'yong'heng'jing'dian	0
欧风纯棉四件套优雅恋歌	ou'feng'chun'mian'si'jian'tao'you'ya'lian'ge	0
欧风纯棉四件套真挚情感	ou'feng'chun'mian'si'jian'tao'zhen'zhi'qing'gan	0
欧风纯棉四件套砖红爱的乐园	ou'feng'chun'mian'si'jian'tao'zhuan'hong'ai'de'le'yuan	0
欧风纯棉四件套紫	ou'feng'chun'mian'si'jian'tao'zi	0
偶逢词客与琼瑰	ou'feng'ci'ke'yu'qiong'gui	0
瓯丰大果园	ou'feng'da'guo'yuan	0
偶逢大吕翁	ou'feng'da'lv'weng	0
偶逢洞仙博	ou'feng'dong'xian'bo	0
欧风二桥	ou'feng'er'qiao	0
欧风发带	ou'feng'fa'dai	0
欧风发带红	ou'feng'fa'dai'hong	0
欧风阁	ou'feng'ge	0
欧风格诺	ou'feng'ge'nuo	0
偶逢故人至	ou'feng'gu'ren'zhi	0
欧风果园	ou'feng'guo'yuan	0
欧凤华	ou'feng'hua	0
欧风花都	ou'feng'hua'du	0
欧风华庭	ou'feng'hua'ting	0
欧风花园	ou'feng'hua'yuan	0
偶逢佳境心已醉	ou'feng'jia'jing'xin'yi'zui	0
欧风家具	ou'feng'jia'ju	0
偶逢佳士亦写真	ou'feng'jia'shi'yi'xie'zhen	0
欧风家园	ou'feng'jia'yuan	0
偶逢江南客	ou'feng'jiang'nan'ke	0
欧风街	ou'feng'jie	0
偶逢金华使	ou'feng'jin'hua'shi	0
偶逢精识见奖拔	ou'feng'jing'shi'jian'jiang'ba	0
偶逢旧治年频熟	ou'feng'jiu'zhi'nian'pin'shu	0
偶逢老僧听僧话	ou'feng'lao'seng'ting'seng'hua	0
欧风丽景	ou'feng'li'jing	0
欧风丽苑	ou'feng'li'yuan	0
欧风路	ou'feng'lu	0
欧风美雨	ou'feng'mei'yu	0
欧风墨雨	ou'feng'mo'yu	0
欧风南	ou'feng'nan	0
偶逢蒲家郎	ou'feng'pu'jia'lang	0
偶逢其适	ou'feng'qi'shi	0
偶逢樵者问山名	ou'feng'qiao'zhe'wen'shan'ming	0
藕风轻	ou'feng'qing	0
欧奉仁	ou'feng'ren	0
欧风三桥	ou'feng'san'qiao	0
欧风商务	ou'feng'shang'wu	0
欧风商业街	ou'feng'shang'ye'jie	0
欧风摄影	ou'feng'she'ying	0
欧风西饼屋	ou'feng'xi'bing'wu	0
偶逢西风便	ou'feng'xi'feng'bian	0
欧凤西装裤	ou'feng'xi'zhuang'ku	0
偶峰镶嵌	ou'feng'xiang'qian	0
偶峰镶嵌格	ou'feng'xiang'qian'ge	0
偶逢携酒便与饮	ou'feng'xie'jiu'bian'yu'yin	0
欧风新天地	ou'feng'xin'tian'di	0
偶逢新语书红叶	ou'feng'xin'yu'shu'hong'ye	0
偶逢休暇追凫鹜	ou'feng'xiu'xia'zhui'fu'wu	0
偶逢野果将呼子	ou'feng'ye'guo'jiang'hu'zi	0
偶逢隐几何须问	ou'feng'yin'ji'he'xu'wen	0
欧风印象	ou'feng'yin'xiang	0
偶逢游女暂相亲	ou'feng'you'nv'zan'xiang'qin	0
欧风园	ou'feng'yuan	0
欧风苑	ou'feng'yuan	0
欧佛洛绪涅	ou'fo'luo'xu'nie	0
欧副	ou'fu	0
欧富	ou'fu	0
欧福	ou'fu	0
沤浮	ou'fu	0
藕覆	ou'fu	0
欧富村	ou'fu'cun	0
欧伏电气	ou'fu'dian'qi	0
鸥凫共浴	ou'fu'gong'yu	0
欧夫雷	ou'fu'lei	0
欧夫雷的特殊鱼饵	ou'fu'lei'de'te'shu'yu'er	0
欧芙琳化妆品公司	ou'fu'lin'hua'zhuang'pin'gong'si	0
鸥浮鹭立	ou'fu'lu'li	0
欧肤敏	ou'fu'min	0
沤浮泡影	ou'fu'pao'ying	0
偶负责	ou'fu'ze	0
沤浮子	ou'fu'zi	0
欧嘎	ou'ga	0
偶改了	ou'gai'le	0
欧盖伊勒王朝	ou'gai'yi'le'wang'chao	0
瓯柑	ou'gan	0
藕干	ou'gan	0
欧岗	ou'gang	0
欧岗北街	ou'gang'bei'jie	0
欧港昌盛	ou'gang'chang'sheng	0
欧岗村	ou'gang'cun	0
偶刚回家	ou'gang'hui'jia	0
欧港名品	ou'gang'ming'pin	0
欧岗南一街	ou'gang'nan'yi'jie	0
偶刚去	ou'gang'qu	0
欧港西街	ou'gang'xi'jie	0
欧港鞋业	ou'gang'xie'ye	0
欧高德	ou'gao'de	0
欧高公路	ou'gao'gong'lu	0
欧高路弄	ou'gao'lu'nong	0
偶个	ou'ge	0
偶格	ou'ge	0
欧歌	ou'ge	0
欧葛	ou'ge	0
欧阁	ou'ge	0
欧鸽	ou'ge	0
藕哥	ou'ge	0
讴歌	ou'ge	0
鸥蛤	ou'ge	0
讴歌奥迪	ou'ge'ao'di	0
欧歌堡	ou'ge'bao	0
讴歌从圣主	ou'ge'cong'sheng'zhu	0
讴歌德义丰	ou'ge'de'yi'feng	0
欧格登	ou'ge'deng	0
欧格登驻地	ou'ge'deng'zhu'di	0
讴歌帝业成	ou'ge'di'ye'cheng	0
欧歌鸫	ou'ge'dong	0
欧格尔	ou'ge'er	0
偶格饭	ou'ge'fan	0
偶格饭庄	ou'ge'fan'zhuang	0
讴歌归圣子	ou'ge'gui'sheng'zi	0
讴歌归子启	ou'ge'gui'zi'qi	0
讴歌国步康	ou'ge'guo'bu'kang	0
讴歌还受瑞	ou'ge'hai'shou'rui	0
欧格汉姆荒地	ou'ge'han'mu'huang'di	0
讴歌觉有年	ou'ge'jue'you'nian	0
欧格拉克其村委会	ou'ge'la'ke'qi'cun'wei'hui	0
讴歌劳动者	ou'ge'lao'dong'zhe	0
讴歌历数归	ou'ge'li'shu'gui	0
欧格鲁姆	ou'ge'lu'mu	0
讴歌满路归	ou'ge'man'lu'gui	0
讴歌千万家	ou'ge'qian'wan'jia	0
讴歌且顺人	ou'ge'qie'shun'ren	0
讴歌荣耀的黄金剧场	ou'ge'rong'yao'de'huang'jin'ju'chang	0
欧格瑞	ou'ge'rui	0
欧格斯传送点	ou'ge'si'chuan'song'dian	0
欧格斯高地	ou'ge'si'gao'di	0
讴歌四海同	ou'ge'si'hai'tong	0
欧格特恩	ou'ge'te'en	0
讴歌亭育外	ou'ge'ting'yu'wai	0
讴歌同戴启	ou'ge'tong'dai'qi	0
欧格托领地	ou'ge'tuo'ling'di	0
讴歌移火德	ou'ge'yi'huo'de	0
讴歌已入云韶曲	ou'ge'yi'ru'yun'shao'qu	0
讴歌元	ou'ge'yuan	0
讴歌者不讴歌丹硃而讴歌舜	ou'ge'zhe'bu'ou'ge'dan'zhu'er'ou'ge'shun	0
欧戈庄	ou'ge'zhuang	0
欧格装饰	ou'ge'zhuang'shi	0
欧根	ou'gen	0
欧根缎	ou'gen'duan	0
欧根河	ou'gen'he	0
藕根莲子相留连	ou'gen'lian'zi'xiang'liu'lian	0
欧根亲王	ou'gen'qin'wang	0
欧根纱	ou'gen'sha	0
欧根沙恩霍斯特希佩尔柯尼斯堡	ou'gen'sha'en'huo'si'te'xi'pei'er'ke'ni'si'bao	0
耦耕	ou'geng	0
藕耕	ou'geng	0
耦耕非艰难	ou'geng'fei'jian'nan	0
耦耕若便遗身老	ou'geng'ruo'bian'yi'shen'lao	0
耦耕乡	ou'geng'xiang	0
耦耕镇	ou'geng'zhen	0
欧公陂	ou'gong'bei	0
欧贡界	ou'gong'jie	0
欧宫丽殿	ou'gong'li'dian	0
殴公骂婆	ou'gong'ma'po	0
欧共鹏润	ou'gong'peng'run	0
讴功颂德	ou'gong'song'de	0
欧公嵩岳步	ou'gong'song'yue'bu	0
欧共体	ou'gong'ti	0
欧共体内零比率交易	ou'gong'ti'nei'ling'bi'lv'jiao'yi	0
欧共体内税收交易	ou'gong'ti'nei'shui'shou'jiao'yi	0
欧共体特惠制	ou'gong'ti'te'hui'zhi	0
欧公自是游嵩观	ou'gong'zi'shi'you'song'guan	0
偶狗	ou'gou	0
偶古	ou'gu	0
欧古巴特	ou'gu'ba'te	0
欧固场	ou'gu'chang	0
欧古尔族	ou'gu'er'zu	0
欧顾景	ou'gu'jing	0
欧怪褚妍不自持	ou'guai'zhu'yan'bu'zi'chi	0
欧冠	ou'guan	0
藕官	ou'guan	0
藕官二人跟了地藏庵的圆信	ou'guan'er'ren'gen'le'di'zang'an'de'yuan'xin	0
藕官见了宝玉	ou'guan'jian'le'bao'yu	0
欧冠决赛	ou'guan'jue'sai	0
藕官冷笑道	ou'guan'leng'xiao'dao	0
藕官两个一边一个	ou'guan'liang'ge'yi'bian'yi'ge	0
藕官认了我姨妈	ou'guan'ren'le'wo'yi'ma	0
藕官先同我们去等着	ou'guan'xian'tong'wo'men'qu'deng'zhe	0
藕官因方才护庇之情	ou'guan'yin'fang'cai'hu'bi'zhi'qing	0
藕官正没了主意	ou'guan'zheng'mei'le'zhu'yi	0
偶逛	ou'guang	0
欧光慈	ou'guang'ci	0
欧光沙拉明	ou'guang'sha'la'ming	0
欧规	ou'gui	0
鏂规枌	ou'gui'fen	0
欧圭环	ou'gui'huan	0
偶归塞马应何定	ou'gui'sai'ma'ying'he'ding	0
鸥归势何懒	ou'gui'shi'he'lan	0
鸥归只故池	ou'gui'zhi'gu'chi	0
欧果	ou'guo	0
欧国和	ou'guo'he	0
偶过河间寻往迹	ou'guo'he'jian'xun'wang'ji	0
偶过明君琳养石轩	ou'guo'ming'jun'lin'yang'shi'xuan	0
欧国葡萄	ou'guo'pu'tao	0
欧哈	ou'ha	0
耦哈哈	ou'ha'ha	0
欧哈玛金熊鼓	ou'ha'ma'jin'xiong'gu	0
欧哈玛双型鼓	ou'ha'ma'shuang'xing'gu	0
欧哈玛银熊鼓	ou'ha'ma'yin'xiong'gu	0
偶嗨	ou'hai	0
呕嗨	ou'hai	0
欧海	ou'hai	0
瓯海	ou'hai	0
瓯海安足鞋业有限公司	ou'hai'an'zu'xie'ye'you'xian'gong'si	0
瓯海奥利康鞋业有限公司	ou'hai'ao'li'kang'xie'ye'you'xian'gong'si	0
瓯海百达鞋业有限公司	ou'hai'bai'da'xie'ye'you'xian'gong'si	0
瓯海佰利得鞋业服装有限公司	ou'hai'bai'li'de'xie'ye'fu'zhuang'you'xian'gong'si	0
瓯海必登高鞋业有限公司	ou'hai'bi'deng'gao'xie'ye'you'xian'gong'si	0
瓯海宾	ou'hai'bin	0
瓯海宾馆	ou'hai'bin'guan	0
瓯海大道	ou'hai'da'dao	0
瓯海大东鞋业公司	ou'hai'da'dong'xie'ye'gong'si	0
瓯海大富豪鞋业有限公司	ou'hai'da'fu'hao'xie'ye'you'xian'gong'si	0
瓯海大厦	ou'hai'da'sha	0
瓯海的	ou'hai'de	0
瓯海登尔乐鞋业有限公司	ou'hai'deng'er'le'xie'ye'you'xian'gong'si	0
瓯海东方工艺试验厂	ou'hai'dong'fang'gong'yi'shi'yan'chang	0
瓯海二高	ou'hai'er'gao	0
瓯海二运公司	ou'hai'er'yun'gong'si	0
瓯海飞达服装鞋服厂	ou'hai'fei'da'fu'zhuang'xie'fu'chang	0
瓯海飞剑皮革有限公司	ou'hai'fei'jian'pi'ge'you'xian'gong'si	0
瓯海飞鸟鞋业有限公司	ou'hai'fei'niao'xie'ye'you'xian'gong'si	0
瓯海富宏达鞋业有限公司	ou'hai'fu'hong'da'xie'ye'you'xian'gong'si	0
瓯海福美特鞋业有限公司	ou'hai'fu'mei'te'xie'ye'you'xian'gong'si	0
瓯海富祥皮革有限公司	ou'hai'fu'xiang'pi'ge'you'xian'gong'si	0
瓯海郭溪宝来康鞋业有限公司	ou'hai'guo'xi'bao'lai'kang'xie'ye'you'xian'gong'si	0
瓯海洪得利鞋业有限公司	ou'hai'hong'de'li'xie'ye'you'xian'gong'si	0
瓯海宏利达鞋业有限公司	ou'hai'hong'li'da'xie'ye'you'xian'gong'si	0
瓯海红旗皮革机械有限公司	ou'hai'hong'qi'pi'ge'ji'xie'you'xian'gong'si	0
瓯海宏伟鞋业有限公司	ou'hai'hong'wei'xie'ye'you'xian'gong'si	0
瓯海华利鞋业	ou'hai'hua'li'xie'ye	0
瓯海惠尔达鞋业有限公司	ou'hai'hui'er'da'xie'ye'you'xian'gong'si	0
瓯海货运市场	ou'hai'huo'yun'shi'chang	0
瓯海交警大队	ou'hai'jiao'jing'da'dui	0
瓯海交警二中队	ou'hai'jiao'jing'er'zhong'dui	0
欧海金	ou'hai'jin	0
瓯海金利林鞋业有限公司	ou'hai'jin'li'lin'xie'ye'you'xian'gong'si	0
瓯海经济开发区	ou'hai'jing'ji'kai'fa'qu	0
瓯海精良鞋业有限公司	ou'hai'jing'liang'xie'ye'you'xian'gong'si	0
瓯海景山宏都鞋业有限公司	ou'hai'jing'shan'hong'dou'xie'ye'you'xian'gong'si	0
瓯海巨能鞋业	ou'hai'ju'neng'xie'ye	0
瓯海巨溪制革皮件八厂	ou'hai'ju'xi'zhi'ge'pi'jian'ba'chang	0
欧海科技	ou'hai'ke'ji	0
瓯海凌达鞋业	ou'hai'ling'da'xie'ye	0
瓯海麦富康鞋业有限公司	ou'hai'mai'fu'kang'xie'ye'you'xian'gong'si	0
瓯海满春园鞋业有限公司	ou'hai'man'chun'yuan'xie'ye'you'xian'gong'si	0
瓯海美利士鞋业有限公司	ou'hai'mei'li'shi'xie'ye'you'xian'gong'si	0
偶还没去打	ou'hai'mei'qu'da	0
瓯海岷岗仙童鞋厂	ou'hai'min'gang'xian'tong'xie'chang	0
瓯海南方鞋业有限公司	ou'hai'nan'fang'xie'ye'you'xian'gong'si	0
瓯海南宇鞋业有限公司	ou'hai'nan'yu'xie'ye'you'xian'gong'si	0
瓯海瓯福服装皮鞋厂	ou'hai'ou'fu'fu'zhuang'pi'xie'chang	0
瓯海潘桥三马鞋业有限公司	ou'hai'pan'qiao'san'ma'xie'ye'you'xian'gong'si	0
瓯海强伟春皮革有限公司	ou'hai'qiang'wei'chun'pi'ge'you'xian'gong'si	0
瓯海轻工特色园区双堡路	ou'hai'qing'gong'te'se'yuan'qu'shuang'bao'lu	0
瓯海区	ou'hai'qu	0
瓯海区第二人民医院	ou'hai'qu'di'er'ren'min'yi'yuan	0
瓯海区府	ou'hai'qu'fu	0
瓯海区府东小区	ou'hai'qu'fu'dong'xiao'qu	0
瓯海区府荣新路	ou'hai'qu'fu'rong'xin'lu	0
瓯海区瓯昌饭店	ou'hai'qu'ou'chang'fan'dian	0
瓯海区医院	ou'hai'qu'yi'yuan	0
瓯海区政府	ou'hai'qu'zheng'fu	0
瓯海群惠鞋业有限公司	ou'hai'qun'hui'xie'ye'you'xian'gong'si	0
瓯海任桥红得利鞋业有限公司	ou'hai'ren'qiao'hong'de'li'xie'ye'you'xian'gong'si	0
瓯海赛尔鞋业有限公司	ou'hai'sai'er'xie'ye'you'xian'gong'si	0
瓯海三溪制革皮件三厂	ou'hai'san'xi'zhi'ge'pi'jian'san'chang	0
瓯海三医	ou'hai'san'yi	0
瓯海神童鞋厂	ou'hai'shen'tong'xie'chang	0
瓯海顺行鞋业有限公司	ou'hai'shun'xing'xie'ye'you'xian'gong'si	0
瓯海四方鞋业有限公司	ou'hai'si'fang'xie'ye'you'xian'gong'si	0
瓯海淘气王鞋业有限公司	ou'hai'tao'qi'wang'xie'ye'you'xian'gong'si	0
瓯海天才童鞋厂	ou'hai'tian'cai'tong'xie'chang	0
瓯海添添童鞋厂	ou'hai'tian'tian'tong'xie'chang	0
瓯海新大地鞋业有限公司	ou'hai'xin'da'di'xie'ye'you'xian'gong'si	0
瓯海鑫贵鞋业有限公司	ou'hai'xin'gui'xie'ye'you'xian'gong'si	0
瓯海兴富达鞋业有限公司	ou'hai'xing'fu'da'xie'ye'you'xian'gong'si	0
瓯海兴泰皮革有限公司	ou'hai'xing'tai'pi'ge'you'xian'gong'si	0
瓯海羊毛衫二厂	ou'hai'yang'mao'shan'er'chang	0
瓯海哟	ou'hai'yo	0
瓯海永银利鞋业	ou'hai'yong'yin'li'xie'ye	0
瓯海元得利鞋业有限公司	ou'hai'yuan'de'li'xie'ye'you'xian'gong'si	0
瓯海远足鞋业有限公司	ou'hai'yuan'zu'xie'ye'you'xian'gong'si	0
偶还仗内身如寄	ou'hai'zhang'nei'shen'ru'ji	0
瓯海正达皮革有限公司	ou'hai'zheng'da'pi'ge'you'xian'gong'si	0
瓯海正义鞋业有限公司	ou'hai'zheng'yi'xie'ye'you'xian'gong'si	0
瓯海中学	ou'hai'zhong'xue	0
瓯海自乐登鞋业公司	ou'hai'zi'le'deng'xie'ye'gong'si	0
欧韩	ou'han	0
欧韩服饰	ou'han'fu'shi	0
欧韩经典	ou'han'jing'dian	0
歐漢尼斯	ou'han'ni'si	0
欧汉升	ou'han'sheng	0
欧汉声	ou'han'sheng	0
偶函数	ou'han'shu	0
偶函数和奇函数	ou'han'shu'he'ji'han'shu	0
欧翰艺	ou'han'yi	0
欧豪	ou'hao	0
欧好光电	ou'hao'guang'dian	0
欧豪同款外套	ou'hao'tong'kuan'wai'tao	0
偶合	ou'he	0
欧和	ou'he	0
欧核	ou'he	0
沤和	ou'he	0
耦合	ou'he	0
耦合摆	ou'he'bai	0
耦合比	ou'he'bi	0
耦合变压器	ou'he'bian'ya'qi	0
鸥鹤不我疏	ou'he'bu'wo'shu	0
耦合参数	ou'he'can'shu	0
耦合层厚度	ou'he'ceng'hou'du	0
耦合常数	ou'he'chang'shu	0
耦合常数跑动	ou'he'chang'shu'pao'dong	0
耦合传输线	ou'he'chuan'shu'xian	0
欧合村	ou'he'cun	0
欧河村	ou'he'cun	0
耦合电感	ou'he'dian'gan	0
耦合电路	ou'he'dian'lu	0
耦合电平	ou'he'dian'ping	0
耦合电容	ou'he'dian'rong	0
耦合电容器	ou'he'dian'rong'qi	0
耦合电阻	ou'he'dian'zu	0
耦合度	ou'he'du	0
偶合反应	ou'he'fan'ying	0
耦合反应	ou'he'fan'ying	0
耦合工况	ou'he'gong'kuang	0
藕和桂花	ou'he'gui'hua	0
耦合环	ou'he'huan	0
耦合剂	ou'he'ji	0
藕合剂	ou'he'ji	0
耦合剂反射波	ou'he'ji'fan'she'bo	0
耦合剂声阻抗	ou'he'ji'sheng'zu'kang	0
耦合间隙	ou'he'jian'xi	0
耦合介质	ou'he'jie'zhi	0
耦合金属	ou'he'jin'shu	0
沤和俱舍罗	ou'he'ju'she'luo	0
沤和拘舍罗	ou'he'ju'she'luo	0
耦合壳模型	ou'he'ke'mo'xing	0
耦合孔	ou'he'kong	0
耦合空间	ou'he'kong'jian	0
耦合口	ou'he'kou	0
耦合力	ou'he'li	0
欧荷利桥	ou'he'li'qiao	0
耦合模	ou'he'mo	0
耦合频率	ou'he'pin'lv	0
偶合器	ou'he'qi	0
耦合器	ou'he'qi	0
耦合器工况	ou'he'qi'gong'kuang	0
耦合器损耗	ou'he'qi'sun'hao	0
耦合腔法互易校准	ou'he'qiang'fa'hu'yi'jiao'zhun	0
耦合腔技术	ou'he'qiang'ji'shu	0
耦合腔慢波线	ou'he'qiang'man'bo'xian	0
偶合染色体	ou'he'ran'se'ti	0
藕荷色	ou'he'se	0
藕荷色染色剂	ou'he'se'ran'se'ji	0
沤呵沙	ou'he'sha	0
耦合设备	ou'he'she'bei	0
耦合损耗	ou'he'sun'hao	0
耦合损耗的测定	ou'he'sun'hao'de'ce'ding	0
欧赫塔	ou'he'ta	0
耦合探针	ou'he'tan'zhen	0
藕荷塘	ou'he'tang	0
偶合体	ou'he'ti	0
耦合系	ou'he'xi	0
偶核细胞	ou'he'xi'bao	0
耦合系数	ou'he'xi'shu	0
耦合系统	ou'he'xi'tong	0
耦合线圈	ou'he'xian'quan	0
耦合线图	ou'he'xian'tu	0
耦合效率	ou'he'xiao'lv	0
耦合型光合波器	ou'he'xing'guang'he'bo'qi	0
鸥鹤休怀钓渚孤	ou'he'xiu'huai'diao'zhu'gu	0
鸥和雪浪翻	ou'he'xue'lang'fan	0
讴和扬阿	ou'he'yang'a	0
偶合氧化	ou'he'yang'hua	0
欧合叶子	ou'he'ye'zi	0
耦合因数	ou'he'yin'shu	0
耦合与补偿	ou'he'yu'bu'chang	0
耦合与衰减	ou'he'yu'shuai'jian	0
耦合元件	ou'he'yuan'jian	0
耦合运动	ou'he'yun'dong	0
耦合杂志	ou'he'za'zhi	0
耦合振荡	ou'he'zhen'dang	0
耦合振动	ou'he'zhen'dong	0
耦合振型	ou'he'zhen'xing	0
偶合终止	ou'he'zhong'zhi	0
耦合装药	ou'he'zhuang'yao	0
耦合阻抗	ou'he'zu'kang	0
欧黑	ou'hei	0
欧黑杨粉毛蚜	ou'hei'yang'fen'mao'ya	0
偶很好奇	ou'hen'hao'qi	0
欧亨	ou'heng	0
欧恒皓	ou'heng'hao	0
欧亨利	ou'heng'li	0
欧亨利吧	ou'heng'li'ba	0
欧亨利短篇小说精选	ou'heng'li'duan'pian'xiao'shuo'jing'xuan	0
藕红	ou'hong	0
欧红灿组	ou'hong'can'zu	0
欧虹小区	ou'hong'xiao'qu	0
偶后	ou'hou	0
呕吼	ou'hou	0
欧侯	ou'hou	0
欧湖	ou'hu	0
藕湖	ou'hu	0
藕胡	ou'hu	0
藕湖浜	ou'hu'bang	0
藕湖浜公寓	ou'hu'bang'gong'yu	0
藕湖浜社区	ou'hu'bang'she'qu	0
藕湖村	ou'hu'cun	0
欧湖岛	ou'hu'dao	0
欧湖岛河	ou'hu'dao'he	0
欧湖岛河鲜	ou'hu'dao'he'xian	0
欧湖岛河鲜酒楼	ou'hu'dao'he'xian'jiu'lou	0
欧湖公寓	ou'hu'gong'yu	0
偶呼黄帽语	ou'hu'huang'mao'yu	0
欧鹄靖	ou'hu'jing	0
欧胡勒汉	ou'hu'le'han	0
瓯湖线	ou'hu'xian	0
欧华	ou'hua	0
藕花	ou'hua	0
藕花初醒莼丝老	ou'hua'chu'xing'chun'si'lao	0
欧花蝽	ou'hua'chun	0
藕花村	ou'hua'cun	0
欧华达	ou'hua'da	0
欧华电脑	ou'hua'dian'nao	0
藕花多处复开亭	ou'hua'duo'chu'fu'kai'ting	0
欧化工	ou'hua'gong	0
藕花红绕鉴中开	ou'hua'hong'rao'jian'zhong'kai	0
欧化家纺	ou'hua'jia'fang	0
欧化家私	ou'hua'jia'si	0
藕花借与稻花秋	ou'hua'jie'yu'dao'hua'qiu	0
偶话旧事	ou'hua'jiu'shi	0
藕花落尽见莲心	ou'hua'luo'jin'jian'lian'xin	0
欧桦潜叶蜂	ou'hua'qian'ye'feng	0
欧化莎片	ou'hua'sha'pian	0
欧华武昌电站	ou'hua'wu'chang'dian'zhan	0
欧化武昌水库大坝	ou'hua'wu'chang'shui'ku'da'ba	0
藕花香满时	ou'hua'xiang'man'shi	0
欧华小区	ou'hua'xiao'qu	0
欧化药业有限公司	ou'hua'yao'ye'you'xian'gong'si	0
欧华逸景香山	ou'hua'yi'jing'xiang'shan	0
欧华逸景小镇	ou'hua'yi'jing'xiao'zhen	0
藕花雨湿前胡夜	ou'hua'yu'shi'qian'hu'ye	0
欧华园	ou'hua'yuan	0
藕花苑	ou'hua'yuan	0
欧华职业技术学院	ou'hua'zhi'ye'ji'shu'xue'yuan	0
藕花州	ou'hua'zhou	0
藕花洲	ou'hua'zhou	0
藕花洲大街	ou'hua'zhou'da'jie	0
藕花洲公寓	ou'hua'zhou'gong'yu	0
藕花洲假	ou'hua'zhou'jia	0
藕花洲假日酒店	ou'hua'zhou'jia'ri'jiu'dian	0
欧华庄园	ou'hua'zhuang'yuan	0
偶怀济物志	ou'huai'ji'wu'zhi	0
欧怀民	ou'huai'min	0
偶怀因壤石	ou'huai'yin'rang'shi	0
偶桓	ou'huan	0
偶唤归舟隔乱溪	ou'huan'gui'zhou'ge'luan'xi	0
欧缓施	ou'huan'shi	0
偶宦心非累	ou'huan'xin'fei'lei	0
欧环缘蝽	ou'huan'yuan'chun	0
欧皇	ou'huang	0
欧皇的烦恼	ou'huang'de'fan'nao	0
欧黄家村	ou'huang'jia'cun	0
欧皇狂欢谷	ou'huang'kuang'huan'gu	0
欧皇斩	ou'huang'zhan	0
欧惠	ou'hui	0
欧蕙	ou'hui	0
欧辉	ou'hui	0
鸥灰蝶属	ou'hui'die'shu	0
呕哕腹痛阴寒盛	ou'hui'fu'tong'yin'han'sheng	0
呕哕腹痛阴寒盛再加附子更扶阳	ou'hui'fu'tong'yin'han'sheng'zai'jia'fu'zi'geng'fu'yang	0
偶会好起来的	ou'hui'hao'qi'lai'de	0
欧辉五金	ou'hui'wu'jin	0
偶会一路	ou'hui'yi'lu	0
偶或	ou'huo	0
偶获	ou'huo	0
欧货	ou'huo	0
偶或成之	ou'huo'cheng'zhi	0
偶获此闲居	ou'huo'ci'xian'ju	0
怄火灰	ou'huo'hui	0
欧活血丹	ou'huo'xue'dan	0
欧货早春外套	ou'huo'zao'chun'wai'tao	0
偶寄	ou'ji	0
偶极	ou'ji	0
偶济	ou'ji	0
欧吉	ou'ji	0
欧基	ou'ji	0
欧机	ou'ji	0
欧记	ou'ji	0
欧集	ou'ji	0
讴集	ou'ji	0
欧吉比	ou'ji'bi	0
欧吉比萨	ou'ji'bi'sa	0
欧吉比萨店	ou'ji'bi'sa'dian	0
偶记不得	ou'ji'bu'de	0
偶极测深	ou'ji'ce'shen	0
偶极层	ou'ji'ceng	0
偶极层直接耦合	ou'ji'ceng'zhi'jie'ou'he	0
偶极场	ou'ji'chang	0
偶极畴	ou'ji'chou	0
偶极磁场	ou'ji'ci'chang	0
偶记错了	ou'ji'cuo'le	0
欧吉达	ou'ji'da	0
偶记滴	ou'ji'di	0
偶极电场	ou'ji'dian'chang	0
偶极电极	ou'ji'dian'ji	0
偶极点阵	ou'ji'dian'zhen	0
欧记多味馆	ou'ji'duo'wei'guan	0
欧吉尔	ou'ji'er	0
欧吉尔德	ou'ji'er'de	0
欧吉尔德伊佛瑞克	ou'ji'er'de'yi'fo'rui'ke	0
偶级反射	ou'ji'fan'she	0
偶极分子	ou'ji'fen'zi	0
偶级分子	ou'ji'fen'zi	0
欧姬蜂属	ou'ji'feng'shu	0
欧姬芙	ou'ji'fu	0
偶极辐射	ou'ji'fu'she	0
欧记广	ou'ji'guang	0
欧记广州	ou'ji'guang'zhou	0
欧记广州大排档	ou'ji'guang'zhou'da'pai'dang	0
偶极极化	ou'ji'ji'hua	0
呕鸡酱	ou'ji'jiang	0
偶极晶格	ou'ji'jing'ge	0
偶极矩	ou'ji'ju	0
欧吉克圣战军	ou'ji'ke'sheng'zhan'jun	0
欧几里得	ou'ji'li'de	0
欧几里德	ou'ji'li'de	0
欧几里得场论	ou'ji'li'de'chang'lun	0
欧几里得度量	ou'ji'li'de'du'liang	0
欧几里得范数	ou'ji'li'de'fan'shu	0
欧几里得几何	ou'ji'li'de'ji'he	0
欧几里德几何	ou'ji'li'de'ji'he	0
欧几里得距离	ou'ji'li'de'ju'li	0
欧几里德距离	ou'ji'li'de'ju'li	0
欧几里得空间	ou'ji'li'de'kong'jian	0
欧几里得路西菲格斯	ou'ji'li'de'lu'xi'fei'ge'si	0
欧几里得平面	ou'ji'li'de'ping'mian	0
欧几里得平行公设	ou'ji'li'de'ping'xing'gong'she	0
欧几里得算法	ou'ji'li'de'suan'fa	0
欧几里德算法	ou'ji'li'de'suan'fa	0
欧几里得向量空间	ou'ji'li'de'xiang'liang'kong'jian	0
欧几里得引理	ou'ji'li'de'yin'li	0
欧几里得整环	ou'ji'li'de'zheng'huan	0
偶极离子	ou'ji'li'zi	0
偶级离子	ou'ji'li'zi	0
偶极离子络合物	ou'ji'li'zi'luo'he'wu	0
偶极流	ou'ji'liu	0
欧记美	ou'ji'mei	0
欧记美食	ou'ji'mei'shi	0
偶极偶极相互作用	ou'ji'ou'ji'xiang'hu'zuo'yong	0
偶极排列	ou'ji'pai'lie	0
偶极品	ou'ji'pin	0
偶极剖面法	ou'ji'pou'mian'fa	0
偶极气体	ou'ji'qi'ti	0
偶极亲质子溶剂	ou'ji'qin'zhi'zi'rong'ji	0
偶极取向	ou'ji'qu'xiang	0
欧集赏	ou'ji'shang	0
偶极式虚实分量法	ou'ji'shi'xu'shi'fen'liang'fa	0
欧记水	ou'ji'shui	0
欧记水煮	ou'ji'shui'zhu	0
欧记水煮鱼	ou'ji'shui'zhu'yu	0
偶极天线	ou'ji'tian'xian	0
偶极位错	ou'ji'wei'cuo	0
欧基文	ou'ji'wen	0
偶极性	ou'ji'xing	0
偶极形成	ou'ji'xing'cheng	0
偶济轩	ou'ji'xuan	0
偶济轩面	ou'ji'xuan'mian	0
偶济轩面家	ou'ji'xuan'mian'jia	0
偶寄一微官	ou'ji'yi'wei'guan	0
偶极跃迁	ou'ji'yue'qian	0
偶极振动	ou'ji'zhen'dong	0
偶极装置	ou'ji'zhuang'zhi	0
偶极子	ou'ji'zi	0
偶极子反射率	ou'ji'zi'fan'she'lv	0
偶极子反射体	ou'ji'zi'fan'she'ti	0
偶极子辐射	ou'ji'zi'fu'she	0
偶极子幕形天线	ou'ji'zi'mu'xing'tian'xian	0
偶极子能级	ou'ji'zi'neng'ji	0
偶极子偶极天线	ou'ji'zi'ou'ji'tian'xian	0
偶极子天线	ou'ji'zi'tian'xian	0
殴击罪	ou'ji'zui	0
偶家	ou'jia	0
欧佳	ou'jia	0
欧加	ou'jia	0
欧家	ou'jia	0
藕夹	ou'jia	0
藕家	ou'jia	0
欧家坳	ou'jia'ao	0
欧家坝	ou'jia'ba	0
欧家坝村	ou'jia'ba'cun	0
欧加巴日	ou'jia'ba'ri	0
欧家堡	ou'jia'bao	0
呕家本渴	ou'jia'ben'ke	0
呕家不可用建中汤	ou'jia'bu'ke'yong'jian'zhong'tang	0
欧家槽村	ou'jia'cao'cun	0
欧家冲	ou'jia'chong	0
偶家村	ou'jia'cun	0
欧家村	ou'jia'cun	0
欧家村村委会	ou'jia'cun'cun'wei'hui	0
欧家大塘	ou'jia'da'tang	0
欧家町	ou'jia'ding	0
欧家剅	ou'jia'dou	0
欧家港	ou'jia'gang	0
欧佳谷中学	ou'jia'gu'zhong'xue	0
欧家河	ou'jia'he	0
欧家河村	ou'jia'he'cun	0
欧家豇	ou'jia'jiang	0
偶铗康属	ou'jia'kang'shu	0
欧家夼	ou'jia'kuang	0
欧家夼村	ou'jia'kuang'cun	0
欧家里	ou'jia'li	0
欧家林	ou'jia'lin	0
欧家岭	ou'jia'ling	0
欧家龙	ou'jia'long	0
欧贾蒙	ou'jia'meng	0
欧家庙	ou'jia'miao	0
欧佳木业	ou'jia'mu'ye	0
欧家坪	ou'jia'ping	0
欧家坡	ou'jia'po	0
欧家铺	ou'jia'pu	0
欧家桥	ou'jia'qiao	0
欧家庆	ou'jia'qing	0
欧家人	ou'jia'ren	0
欧家山	ou'jia'shan	0
欧嘉山椒凤爪包组肉类豆干辣条	ou'jia'shan'jiao'feng'zhao'bao'zu'rou'lei'dou'gan'la'tiao	0
欧嘉山椒凤爪肉类豆干辣条	ou'jia'shan'jiao'feng'zhao'rou'lei'dou'gan'la'tiao	0
偶铗属	ou'jia'shu	0
欧家台	ou'jia'tai	0
欧家塘	ou'jia'tang	0
欧佳特建材	ou'jia'te'jian'cai	0
欧家梯田	ou'jia'ti'tian	0
欧家屯	ou'jia'tun	0
欧加万	ou'jia'wan	0
欧家湾	ou'jia'wan	0
欧家湾水库	ou'jia'wan'shui'ku	0
欧家围	ou'jia'wei	0
殴家玮	ou'jia'wei	0
欧家屋场	ou'jia'wu'chang	0
欧家溪	ou'jia'xi	0
欧家乡	ou'jia'xiang	0
欧嘉香酥鸡爪包组肉类豆干辣条	ou'jia'xiang'su'ji'zhua'bao'zu'rou'lei'dou'gan'la'tiao	0
偶家小院	ou'jia'xiao'yuan	0
欧家营	ou'jia'ying	0
呕家有痈脓者	ou'jia'you'yong'nong'zhe	0
呕家有痈脓者不可治呕脓尽自愈	ou'jia'you'yong'nong'zhe'bu'ke'zhi'ou'nong'jin'zi'yu	0
欧家圫	ou'jia'yu	0
欧家园	ou'jia'yuan	0
欧家寨	ou'jia'zhai	0
欧家镇	ou'jia'zhen	0
欧家洲	ou'jia'zhou	0
欧家庄	ou'jia'zhuang	0
欧家组	ou'jia'zu	0
偶件	ou'jian	0
欧健	ou'jian	0
藕尖	ou'jian	0
偶见不能记	ou'jian'bu'neng'ji	0
偶见乘潮出	ou'jian'cheng'chao'chu	0
欧剑窗	ou'jian'chuang	0
偶见法华僧	ou'jian'fa'hua'seng	0
偶见高人眼倍明	ou'jian'gao'ren'yan'bei'ming	0
欧建国	ou'jian'guo	0
欧建杭	ou'jian'hang	0
欧俭君	ou'jian'jun	0
偶见年时解船处	ou'jian'nian'shi'jie'chuan'chu	0
偶见凭栏笑说同	ou'jian'ping'lan'xiao'shuo'tong	0
偶见千峰翠	ou'jian'qian'feng'cui	0
偶见清净源	ou'jian'qing'jing'yuan	0
鸥见人暂起	ou'jian'ren'zan'qi	0
偶见行人回首却	ou'jian'xing'ren'hui'shou'que	0
偶检验	ou'jian'yan	0
欧健药业	ou'jian'yao'ye	0
偶渐余润亦成酣	ou'jian'yu'run'yi'cheng'han	0
偶见在阴墙下葵	ou'jian'zai'yin'qiang'xia'kui	0
偶见种	ou'jian'zhong	0
偶讲	ou'jiang	0
欧江	ou'jiang	0
沤江	ou'jiang	0
瓯江	ou'jiang	0
欧江岔	ou'jiang'cha	0
欧江岔镇	ou'jiang'cha'zhen	0
欧江村	ou'jiang'cun	0
瓯江大酒店	ou'jiang'da'jiu'dian	0
瓯江大桥	ou'jiang'da'qiao	0
欧江大厦	ou'jiang'da'sha	0
瓯江大厦	ou'jiang'da'sha	0
瓯江店	ou'jiang'dian	0
偶将二公合	ou'jiang'er'gong'he	0
瓯江饭店	ou'jiang'fan'dian	0
瓯江凤尾鱼	ou'jiang'feng'wei'yu	0
瓯江高中	ou'jiang'gao'zhong	0
瓯江公	ou'jiang'gong	0
瓯江公寓	ou'jiang'gong'yu	0
鸥江公寓	ou'jiang'gong'yu	0
瓯江购物中心	ou'jiang'gou'wu'zhong'xin	0
瓯江和江心屿	ou'jiang'he'jiang'xin'yu	0
瓯江口	ou'jiang'kou	0
瓯江路	ou'jiang'lu	0
瓯江漂流	ou'jiang'piao'liu	0
鸥江浦寒鸥戏	ou'jiang'pu'han'ou'xi	0
瓯江行	ou'jiang'xing	0
瓯江学院	ou'jiang'xue'yuan	0
瓯江壹号码头	ou'jiang'yi'hao'ma'tou	0
偶叫	ou'jiao	0
欧角	ou'jiao	0
偶角实蝇属	ou'jiao'shi'ying'shu	0
偶校验	ou'jiao'yan	0
藕节	ou'jie	0
欧节达的援助	ou'jie'da'de'yuan'zhu	0
欧节达鬼影议会	ou'jie'da'gui'ying'yi'hui	0
欧节达喉兽	ou'jie'da'hou'shou	0
欧捷利	ou'jie'li	0
欧洁玲	ou'jie'ling	0
欧洁蔓	ou'jie'man	0
藕节藕节炭	ou'jie'ou'jie'tan	0
藕节炭	ou'jie'tan	0
藕节丸	ou'jie'wan	0
藕节柱属	ou'jie'zhu'shu	0
欧杰组	ou'jie'zu	0
偶紧	ou'jin	0
欧津	ou'jin	0
欧金才	ou'jin'cai	0
欧金翅雀	ou'jin'chi'que	0
欧金鸻	ou'jin'heng	0
欧进萍	ou'jin'ping	0
欧锦赛	ou'jin'sai	0
欧劲松	ou'jin'song	0
欧金塘	ou'jin'tang	0
欧锦棠	ou'jin'tang	0
欧锦行	ou'jin'xing	0
欧锦园	ou'jin'yuan	0
偶井	ou'jing	0
欧井	ou'jing	0
欧景	ou'jing	0
欧景宾馆	ou'jing'bin'guan	0
欧景城	ou'jing'cheng	0
欧泾村	ou'jing'cun	0
藕泾村	ou'jing'cun	0
偶经花蕊弄辉辉	ou'jing'hua'rui'nong'hui'hui	0
欧景花园	ou'jing'hua'yuan	0
欧景佳园	ou'jing'jia'yuan	0
欧景嘉园	ou'jing'jia'yuan	0
欧景家园	ou'jing'jia'yuan	0
欧景蓝天	ou'jing'lan'tian	0
欧景蓝湾	ou'jing'lan'wan	0
欧景丽都	ou'jing'li'du	0
瓯景路	ou'jing'lu	0
欧景名苑	ou'jing'ming'yuan	0
欧景庭园	ou'jing'ting'yuan	0
鸥惊误拂凤凰池	ou'jing'wu'fu'feng'huang'chi	0
欧景园	ou'jing'yuan	0
欧景苑	ou'jing'yuan	0
欧竞仲	ou'jing'zhong	0
鸥迥千寻雨	ou'jiong'qian'xun'yu	0
偶就回来了	ou'jiu'hui'lai'le	0
欧九小区	ou'jiu'xiao'qu	0
偶就郁闷滴	ou'jiu'yu'men'di	0
偶剧	ou'ju	0
欧举	ou'ju	0
瓯剧	ou'ju	0
瓯窭满篝	ou'ju'man'gou	0
耦俱无猜	ou'ju'wu'cai	0
耦居无猜	ou'ju'wu'cai	0
欧爵	ou'jue	0
欧觉	ou'jue	0
欧爵比萨	ou'jue'bi'sa	0
欧爵咖	ou'jue'ka	0
欧爵咖啡	ou'jue'ka'fei	0
欧爵瑶	ou'jue'yao	0
欧郡	ou'jun	0
欧卡	ou'ka	0
欧卡果	ou'ka'guo	0
欧卡罗厨柜	ou'ka'luo'chu'gui	0
欧卡罗橱柜	ou'ka'luo'chu'gui	0
欧卡曼	ou'ka'man	0
欧卡舒	ou'ka'shu	0
欧卡樱花北京化妆品有限公司	ou'ka'ying'hua'bei'jing'hua'zhuang'pin'you'xian'gong'si	0
呕开	ou'kai	0
欧凯	ou'kai	0
欧开	ou'kai	0
欧凯阿诺斯	ou'kai'a'nuo'si	0
欧凯的	ou'kai'de	0
欧凯电器	ou'kai'dian'qi	0
欧开股份	ou'kai'gu'fen	0
偶开画卷小山川	ou'kai'hua'juan'xiao'shan'chuan	0
欧凯家具	ou'kai'jia'ju	0
欧凯科技	ou'kai'ke'ji	0
欧凯空	ou'kai'kong	0
欧凯龙	ou'kai'long	0
欧凯罗	ou'kai'luo	0
欧凯罗酒店	ou'kai'luo'jiu'dian	0
欧凯亚食人花	ou'kai'ya'shi'ren'hua	0
欧坎	ou'kan	0
偶看淡了	ou'kan'dan'le	0
瓯坎杀手	ou'kan'sha'shou	0
偶看小树双团乐	ou'kan'xiao'shu'shuang'tuan'le	0
欧康	ou'kang	0
欧康桥	ou'kang'qiao	0
欧康桥西	ou'kang'qiao'xi	0
欧康桥西餐	ou'kang'qiao'xi'can	0
欧康医药	ou'kang'yi'yao	0
欧靠望	ou'kao'wang	0
欧克	ou'ke	0
欧可	ou'ke	0
欧柯	ou'ke	0
欧珂	ou'ke	0
欧科	ou'ke	0
鸥科	ou'ke	0
欧柯餐	ou'ke'can	0
欧柯餐饮	ou'ke'can'yin	0
欧柯餐饮有限公司	ou'ke'can'yin'you'xian'gong'si	0
瓯柯的同伙	ou'ke'de'tong'huo	0
欧克洞	ou'ke'dong	0
欧科豆浆机	ou'ke'dou'jiang'ji	0
欧珂肛舒	ou'ke'gang'shu	0
欧科工业园	ou'ke'gong'ye'yuan	0
欧克哈特大师	ou'ke'ha'te'da'shi	0
欧克基	ou'ke'ji	0
欧克机械	ou'ke'ji'xie	0
欧克精化	ou'ke'jing'hua	0
欧克咖	ou'ke'ka	0
欧克咖啡	ou'ke'ka'fei	0
欧克拉	ou'ke'la	0
欧克拉忒	ou'ke'la'tei	0
欧克勒	ou'ke'le	0
欧克勒恩	ou'ke'le'en	0
欧克里德	ou'ke'li'de	0
偶克利福德代数	ou'ke'li'fu'de'dai'shu	0
欧克利磷酸苯丙酸哌林颗粒	ou'ke'li'lin'suan'ben'bing'suan'pai'lin'ke'li	0
欧可力牌榛子奶油威化巧克力	ou'ke'li'pai'zhen'zi'nai'you'wei'hua'qiao'ke'li	0
欧克美邦	ou'ke'mei'bang	0
欧柯蒙	ou'ke'meng	0
欧克木马	ou'ke'mu'ma	0
欧克泥纸粘土	ou'ke'ni'zhi'nian'tu	0
欧克欧克	ou'ke'ou'ke	0
欧可啤	ou'ke'pi	0
欧可啤酒	ou'ke'pi'jiu	0
欧克瑞克	ou'ke'rui'ke	0
欧克山庄	ou'ke'shan'zhuang	0
瓯柯式恭迎	ou'ke'shi'gong'ying	0
偶可是好孩子啊	ou'ke'shi'hao'hai'zi'a	0
欧克双	ou'ke'shuang	0
欧科提尼曼摇蚊	ou'ke'ti'ni'man'yao'wen	0
欧克魏克数	ou'ke'wei'ke'shu	0
欧克雅	ou'ke'ya	0
欧克壹	ou'ke'yi	0
欧科亿	ou'ke'yi	0
欧克一百	ou'ke'yi'bai	0
欧克壹佰	ou'ke'yi'bai	0
欧克壹佰龙华店	ou'ke'yi'bai'long'hua'dian	0
欧克圆	ou'ke'yuan	0
欧克圆顶	ou'ke'yuan'ding	0
欧克圆顶咖啡	ou'ke'yuan'ding'ka'fei	0
欧肯	ou'ken	0
欧肯河农场	ou'ken'he'nong'chang	0
欧肯河农场场部二队	ou'ken'he'nong'chang'chang'bu'er'dui	0
欧坑	ou'keng	0
藕坑	ou'keng	0
讴坑	ou'keng	0
欧坑村	ou'keng'cun	0
欧坑路	ou'keng'lu	0
欧孔	ou'kong	0
藕孔	ou'kong	0
藕孔是谁锼	ou'kong'shi'shui'sou	0
呕扣	ou'kou	0
欧口	ou'kou	0
欧库	ou'ku	0
呕苦咳哕烦心	ou'ku'ke'hui'fan'xin	0
欧库勒斯	ou'ku'le'si	0
欧库仑	ou'ku'lun	0
欧库塔尔	ou'ku'ta'er	0
偶裤子	ou'ku'zi	0
欧夸提尼曼摇蚊	ou'kua'ti'ni'man'yao'wen	0
欧款	ou'kuan	0
欧匡冉	ou'kuang'ran	0
欧葵提尼曼摇蚊	ou'kui'ti'ni'man'yao'wen	0
欧昆的头	ou'kun'de'tou	0
偶啦	ou'la	0
欧啦	ou'la	0
欧拉	ou'la	0
欧拉艾狼蛛	ou'la'ai'lang'zhu	0
欧拉变换	ou'la'bian'huan	0
欧拉常数	ou'la'chang'shu	0
欧拉定理	ou'la'ding'li	0
欧拉多面体定理	ou'la'duo'mian'ti'ding'li	0
欧拉多项式	ou'la'duo'xiang'shi	0
欧拉厄贾	ou'la'e'jia	0
欧拉尔德	ou'la'er'de	0
欧拉法	ou'la'fa	0
欧拉方程	ou'la'fang'cheng	0
欧拉夫	ou'la'fu	0
欧拉夫断崖	ou'la'fu'duan'ya	0
欧拉父女	ou'la'fu'nv	0
欧拉公式	ou'la'gong'shi	0
欧拉函数	ou'la'han'shu	0
欧拉恒等式	ou'la'heng'deng'shi	0
欧拉回路	ou'la'hui'lu	0
欧拉角	ou'la'jiao	0
欧拉警告	ou'la'jing'gao	0
欧拉鸠	ou'la'jiu	0
欧拉克	ou'la'ke	0
欧拉克蟹	ou'la'ke'xie	0
欧啦啦	ou'la'la	0
欧啦啦餐	ou'la'la'can	0
欧啦啦餐饮地带	ou'la'la'can'yin'di'dai	0
欧拉类	ou'la'lei	0
欧拉丽	ou'la'li	0
欧拉临界力	ou'la'lin'jie'li	0
欧拉临界力砌体拉结钢筋	ou'la'lin'jie'li'qi'ti'la'jie'gang'jin	0
欧拉临界应力	ou'la'lin'jie'ying'li	0
欧拉临界应力钢管	ou'la'lin'jie'ying'li'gang'guan	0
欧拉流体动力学方程	ou'la'liu'ti'dong'li'xue'fang'cheng	0
欧拉路径	ou'la'lu'jing	0
欧拉涅内	ou'la'nie'nei	0
欧拉欧拉	ou'la'ou'la	0
欧拉欧拉欧拉	ou'la'ou'la'ou'la	0
欧拉欧秦	ou'la'ou'qin	0
欧拉判别准则	ou'la'pan'bie'zhun'ze	0
欧拉庞加莱公式	ou'la'pang'jia'lai'gong'shi	0
欧拉示性数	ou'la'shi'xing'shu	0
欧拉数	ou'la'shu	0
欧拉图	ou'la'tu	0
欧拉微分方程	ou'la'wei'fen'fang'cheng	0
欧拉乡	ou'la'xiang	0
欧拉秀玛乡	ou'la'xiu'ma'xiang	0
欧拉旋转矩阵	ou'la'xuan'zhuan'ju'zhen	0
欧拉运动学方程	ou'la'yun'dong'xue'fang'cheng	0
欧拉折线	ou'la'zhe'xian	0
欧拉折线法	ou'la'zhe'xian'fa	0
欧拉周期	ou'la'zhou'qi	0
欧拉柱公式	ou'la'zhu'gong'shi	0
欧拉总和公式	ou'la'zong'he'gong'shi	0
呕来	ou'lai	0
欧来	ou'lai	0
欧莱	ou'lai	0
偶来被簪组	ou'lai'bei'zan'zu	0
欧莱布艺	ou'lai'bu'yi	0
偶来尘外事	ou'lai'chen'wai'shi	0
偶来尘右掖	ou'lai'chen'you'ye	0
偶来乘兴者	ou'lai'cheng'xing'zhe	0
偶来到此醒心目	ou'lai'dao'ci'xing'xin'mu	0
偶来堤上行	ou'lai'di'shang'xing	0
欧莱电子	ou'lai'dian'zi	0
欧莱尔	ou'lai'er	0
偶来贰仪曹	ou'lai'er'yi'cao	0
欧莱坊	ou'lai'fang	0
偶来拂衣去	ou'lai'fu'yi'qu	0
偶来何事去何情	ou'lai'he'shi'qu'he'qing	0
欧莱华	ou'lai'hua	0
偶来花下聊散策	ou'lai'hua'xia'liao'san'ce	0
偶来江外寄行踪	ou'lai'jiang'wai'ji'xing'zong	0
欧莱酒店	ou'lai'jiu'dian	0
欧莱克	ou'lai'ke	0
欧莱克陶瓷	ou'lai'ke'tao'ci	0
欧莱丽姿	ou'lai'li'zi	0
偶来恋沧浪	ou'lai'lian'cang'lang	0
欧莱玛	ou'lai'ma	0
偶来买花处	ou'lai'mai'hua'chu	0
欧莱美	ou'lai'mei	0
偶来你就听到了	ou'lai'ni'jiu'ting'dao'le	0
欧来宁	ou'lai'ning	0
偶来宁有契	ou'lai'ning'you'qi	0
偶来偶来	ou'lai'ou'lai	0
偶来平地著征衣	ou'lai'ping'di'zhu'zheng'yi	0
偶来却胜特来好	ou'lai'que'sheng'te'lai'hao	0
偶来人境外	ou'lai'ren'jing'wai	0
偶来人世值中元	ou'lai'ren'shi'zhi'zhong'yuan	0
偶来山邑便成家	ou'lai'shan'yi'bian'cheng'jia	0
偶来山中坐	ou'lai'shan'zhong'zuo	0
欧莱斯	ou'lai'si	0
偶来似可乐	ou'lai'si'ke'le	0
偶来松树下	ou'lai'song'shu'xia	0
欧莱特	ou'lai'te	0
欧莱特咖	ou'lai'te'ka	0
欧莱特咖啡厅	ou'lai'te'ka'fei'ting	0
偶来闲客独多情	ou'lai'xian'ke'du'duo'qing	0
偶来相就谈	ou'lai'xiang'jiu'tan	0
欧莱娅	ou'lai'ya	0
欧莱雅	ou'lai'ya	0
欧莱雅公司	ou'lai'ya'gong'si	0
欧莱雅国际集团香港有限公司	ou'lai'ya'guo'ji'ji'tuan'xiang'gang'you'xian'gong'si	0
欧莱雅化妆品	ou'lai'ya'hua'zhuang'pin	0
欧莱雅郡	ou'lai'ya'jun	0
欧莱雅美容院	ou'lai'ya'mei'rong'yuan	0
欧莱雅苏州化妆品有限公司	ou'lai'ya'su'zhou'hua'zhuang'pin'you'xian'gong'si	0
欧莱雅专业美发	ou'lai'ya'zhuan'ye'mei'fa	0
偶来伊水曲	ou'lai'yi'shui'qu	0
偶来一笑喜	ou'lai'yi'xiao'xi	0
偶来舟不系	ou'lai'zhou'bu'xi	0
偶来樽俎同	ou'lai'zun'zu'tong	0
欧兰	ou'lan	0
欧蓝德	ou'lan'de	0
沤烂的花生	ou'lan'de'hua'sheng	0
欧兰迪雅	ou'lan'di'ya	0
偶览二子句	ou'lan'er'zi'ju	0
欧兰阁	ou'lan'ge	0
欧兰花园	ou'lan'hua'yuan	0
欧澜家园	ou'lan'jia'yuan	0
偶览胶货哗	ou'lan'jiao'huo'hua	0
欧兰宁	ou'lan'ning	0
欧兰桥	ou'lan'qiao	0
藕缆桥	ou'lan'qiao	0
藕缆桥村	ou'lan'qiao'cun	0
欧兰同	ou'lan'tong	0
欧朗	ou'lang	0
欧郎	ou'lang	0
欧朗地板	ou'lang'di'ban	0
欧朗咖	ou'lang'ka	0
欧朗咖啡	ou'lang'ka'fei	0
欧朗诺克	ou'lang'nuo'ke	0
欧朗诺克之子	ou'lang'nuo'ke'zhi'zi	0
偶佬	ou'lao	0
欧乐	ou'le	0
欧了	ou'le	0
讴乐	ou'le	0
鸥乐	ou'le	0
欧乐宝	ou'le'bao	0
鸥乐包包	ou'le'bao'bao	0
欧乐堡戏水湾艺术养生温泉	ou'le'bao'xi'shui'wan'yi'shu'yang'sheng'wen'quan	0
欧乐堡雨林温泉	ou'le'bao'yu'lin'wen'quan	0
欧乐村	ou'le'cun	0
欧乐迪	ou'le'di	0
鸥乐电脑	ou'le'dian'nao	0
鸥乐电器	ou'le'dian'qi	0
欧乐福	ou'le'fu	0
鸥乐服饰	ou'le'fu'shi	0
鸥乐化妆品	ou'le'hua'zhuang'pin	0
欧勒回旋	ou'le'hui'xuan	0
欧乐基	ou'le'ji	0
欧乐集团	ou'le'ji'tuan	0
欧乐家居	ou'le'jia'ju	0
鸥乐家居	ou'le'jia'ju	0
欧勒伦	ou'le'lun	0
偶了么	ou'le'me	0
欧了么么那么么	ou'le'me'me'na'me'me	0
欧乐美	ou'le'mei	0
欧勒姆福	ou'le'mu'fu	0
鸥乐母婴	ou'le'mu'ying	0
偶了呢	ou'le'ne	0
鸥乐商城	ou'le'shang'cheng	0
鸥乐食品	ou'le'shi'pin	0
欧乐时尚广场	ou'le'shi'shang'guang'chang	0
鸥乐图书	ou'le'tu'shu	0
欧乐湾乐园	ou'le'wan'le'yuan	0
欧乐与召纳	ou'le'yu'zhao'na	0
藕乐苑	ou'le'yuan	0
偶类	ou'lei	0
欧蕾	ou'lei	0
欧镭	ou'lei	0
欧雷	ou'lei	0
殴雷	ou'lei	0
欧雷巴斯	ou'lei'ba'si	0
欧蕾冰咖啡	ou'lei'bing'ka'fei	0
欧蕾缎带	ou'lei'duan'dai	0
欧蕾发卡	ou'lei'fa'ka	0
欧雷加	ou'lei'jia	0
欧蕾加诺	ou'lei'jia'nuo	0
欧蕾咖	ou'lei'ka	0
欧蕾咖啡	ou'lei'ka'fei	0
欧雷明	ou'lei'ming	0
欧雷仕	ou'lei'shi	0
偶俚	ou'li	0
偶里	ou'li	0
欧丽	ou'li	0
欧俪	ou'li	0
欧利	ou'li	0
欧力	ou'li	0
欧历	ou'li	0
欧李	ou'li	0
欧立	ou'li	0
欧里	ou'li	0
瓯里	ou'li	0
耦立	ou'li	0
藕里	ou'li	0
欧立安	ou'li'an	0
欧莉安娜	ou'li'an'na	0
欧力板村	ou'li'ban'cun	0
欧里庇得斯	ou'li'bi'de'si	0
欧里庇德斯	ou'li'bi'de'si	0
欧利波吉他	ou'li'bo'ji'ta	0
欧力产业园	ou'li'chan'ye'yuan	0
偶立此翁妪	ou'li'ci'weng'yu	0
欧力村	ou'li'cun	0
欧李村	ou'li'cun	0
欧里村	ou'li'cun	0
欧俐达	ou'li'da	0
讴立德	ou'li'de	0
欧丽登化妆品有限公司	ou'li'deng'hua'zhuang'pin'you'xian'gong'si	0
欧丽尔	ou'li'er	0
欧利伐	ou'li'fa	0
欧璃芙	ou'li'fu	0
欧立服饰	ou'li'fu'shi	0
呕利腹痛阴寒盛	ou'li'fu'tong'yin'han'sheng	0
欧梨冠网蝽	ou'li'guan'wang'chun	0
欧利合成石	ou'li'he'cheng'shi	0
欧李街	ou'li'jie	0
欧俪咖	ou'li'ka	0
欧俪咖啡	ou'li'ka'fei	0
欧俪咖啡美食	ou'li'ka'fei'mei'shi	0
欧利康	ou'li'kang	0
欧力康	ou'li'kang	0
欧立康定	ou'li'kang'ding	0
欧里刻	ou'li'ke	0
欧莉拉	ou'li'la	0
欧李瘤头蚜	ou'li'liu'tou'ya	0
欧利墨涅	ou'li'mo'nie	0
欧里牧场	ou'li'mu'chang	0
欧丽娜	ou'li'na	0
欧立欧之锤	ou'li'ou'zhi'chui	0
欧力配网	ou'li'pei'wang	0
欧莉普	ou'li'pu	0
欧栎绒蜡蚧	ou'li'rong'la'jie	0
欧丽莎	ou'li'sha	0
偶立韶江侧	ou'li'shao'jiang'ce	0
欧丽舍	ou'li'she	0
欧力士亚洲有	ou'li'shi'ya'zhou'you	0
欧利思	ou'li'si	0
欧力丝	ou'li'si	0
欧力思	ou'li'si	0
欧莉丝	ou'li'si	0
欧利泰	ou'li'tai	0
欧利特	ou'li'te	0
欧力特	ou'li'te	0
欧立停	ou'li'ting	0
欧利维埃	ou'li'wei'ai	0
偶里乡	ou'li'xiang	0
偶里乡八腊村	ou'li'xiang'ba'la'cun	0
偶里乡格溪村	ou'li'xiang'ge'xi'cun	0
偶里乡皎洞村	ou'li'xiang'jiao'dong'cun	0
偶里乡皆久村	ou'li'xiang'jie'jiu'cun	0
偶里乡皆阳村	ou'li'xiang'jie'yang'cun	0
偶里乡赛村村	ou'li'xiang'sai'cun'cun	0
偶里乡云照村	ou'li'xiang'yun'zhao'cun	0
偶里乡寨欧村	ou'li'xiang'zhai'ou'cun	0
偶里乡寨霞村	ou'li'xiang'zhai'xia'cun	0
偶里乡寨先村	ou'li'xiang'zhai'xian'cun	0
欧丽信大	ou'li'xin'da	0
欧丽雅	ou'li'ya	0
欧俪娅	ou'li'ya	0
欧莉娅	ou'li'ya	0
欧利雅化工	ou'li'ya'hua'gong	0
欧里亚克	ou'li'ya'ke	0
欧栎蚜瘿蜂	ou'li'ya'ying'feng	0
欧栎叶蜂属	ou'li'ye'feng'shu	0
欧力营村	ou'li'ying'cun	0
欧力营子村	ou'li'ying'zi'cun	0
欧里营子村	ou'li'ying'zi'cun	0
欧李圆球蚧	ou'li'yuan'qiu'jie	0
欧里镇	ou'li'zhen	0
偶联	ou'lian	0
耦联	ou'lian	0
藕莲	ou'lian	0
欧联杯	ou'lian'bei	0
偶联常数	ou'lian'chang'shu	0
藕莲村	ou'lian'cun	0
藕莲撮	ou'lian'cuo	0
偶联反应	ou'lian'fan'ying	0
欧恋化妆品有限公司	ou'lian'hua'zhuang'pin'you'xian'gong'si	0
欧恋化妆品中国有限公司	ou'lian'hua'zhuang'pin'zhong'guo'you'xian'gong'si	0
偶联剂	ou'lian'ji	0
偶联聚合	ou'lian'ju'he	0
偶联磷酸化	ou'lian'lin'suan'hua	0
偶联磷酸化作用	ou'lian'lin'suan'hua'zuo'yong	0
欧莲娜	ou'lian'na	0
藕莲塘	ou'lian'tang	0
偶练同款衣服	ou'lian'tong'kuan'yi'fu	0
偶联抑制	ou'lian'yi'zhi	0
藕莲饮	ou'lian'yin	0
偶联因子	ou'lian'yin'zi	0
耦联作用	ou'lian'zuo'yong	0
欧凉翔	ou'liang'xiang	0
欧良秀组	ou'liang'xiu'zu	0
欧靓腰支柳一涡	ou'liang'yao'zhi'liu'yi'wo	0
欧廖	ou'liao	0
欧聊	ou'liao	0
欧林	ou'lin	0
欧琳	ou'lin	0
欧霖	ou'lin	0
欧麟	ou'lin	0
欧琳橱柜	ou'lin'chu'gui	0
欧琳厨具	ou'lin'chu'ju	0
欧琳达	ou'lin'da	0
欧琳的吟颂	ou'lin'de'yin'song	0
欧林家具	ou'lin'jia'ju	0
欧琳美	ou'lin'mei	0
欧琳美斯	ou'lin'mei'si	0
欧林生物	ou'lin'sheng'wu	0
欧琳水槽	ou'lin'shui'cao	0
欧林湾	ou'lin'wan	0
欧林雅	ou'lin'ya	0
欧林装饰生活	ou'lin'zhuang'shi'sheng'huo	0
欧岭	ou'ling	0
欧灵	ou'ling	0
欧菱	ou'ling	0
欧流	ou'liu	0
欧柳黄叶蜂	ou'liu'huang'ye'feng	0
偶留一吷千山上	ou'liu'yi'chuo'qian'shan'shang	0
偶留一吷千山上	ou'liu'yi'xue'qian'shan'shang	0
欧柳莺	ou'liu'ying	0
欧珑	ou'long	0
欧隆	ou'long	0
欧龙	ou'long	0
瓯龙	ou'long	0
欧龙胆碱	ou'long'dan'jian	0
欧龙电气	ou'long'dian'qi	0
欧龙集成吊顶	ou'long'ji'cheng'diao'ding	0
瓯龙建筑模型	ou'long'jian'zhu'mo'xing	0
欧龙马滴剂	ou'long'ma'di'ji	0
欧龙漆	ou'long'qi	0
欧龙子	ou'long'zi	0
欧楼	ou'lou	0
欧楼村	ou'lou'cun	0
沤楼频螺	ou'lou'pin'luo	0
沤楼僧佉	ou'lou'seng'qu	0
欧陆	ou'lu	0
欧鲁	ou'lu	0
欧鹭	ou'lu	0
欧鹿	ou'lu	0
欧鲁安派	ou'lu'an'pai	0
欧陆宾馆	ou'lu'bin'guan	0
鸥鹭不相嫌	ou'lu'bu'xiang'xian	0
欧陆餐厅	ou'lu'can'ting	0
欧陆大厦	ou'lu'da'sha	0
欧鲁芬	ou'lu'fen	0
欧陆峰	ou'lu'feng	0
欧陆峰会馆	ou'lu'feng'hui'guan	0
欧陆风情	ou'lu'feng'qing	0
欧陆风情广场	ou'lu'feng'qing'guang'chang	0
欧陆风情街	ou'lu'feng'qing'jie	0
欧陆风情小镇	ou'lu'feng'qing'xiao'zhen	0
欧陆风情影楼	ou'lu'feng'qing'ying'lou	0
欧陆风情园	ou'lu'feng'qing'yuan	0
欧陆风云	ou'lu'feng'yun	0
欧陆广场	ou'lu'guang'chang	0
鸥鹭还来否	ou'lu'hai'lai'fou	0
欧陆豪庭	ou'lu'hao'ting	0
鸥鹭后前如旧物	ou'lu'hou'qian'ru'jiu'wu	0
欧陆花园	ou'lu'hua'yuan	0
欧陆集团	ou'lu'ji'tuan	0
欧陆佳	ou'lu'jia	0
欧陆佳地板	ou'lu'jia'di'ban	0
欧陆家居广场	ou'lu'jia'ju'guang'chang	0
欧陆洁具	ou'lu'jie'ju	0
偶录锦帆泾	ou'lu'jin'fan'jing	0
欧陆经典	ou'lu'jing'dian	0
欧陆经典花园	ou'lu'jing'dian'hua'yuan	0
欧陆经典社区	ou'lu'jing'dian'she'qu	0
欧陆经典万兴苑	ou'lu'jing'dian'wan'xing'yuan	0
鸥鹭惊飞失故洲	ou'lu'jing'fei'shi'gu'zhou	0
欧陆酒吧	ou'lu'jiu'ba	0
欧陆客	ou'lu'ke	0
欧露克活动基地	ou'lu'ke'huo'dong'ji'di	0
欧陆科诺	ou'lu'ke'nuo	0
鸥鹭苦难亲	ou'lu'ku'nan'qin	0
欧陆门垫	ou'lu'men'dian	0
鸥鹭眠沙	ou'lu'mian'sha	0
欧陆名品名店	ou'lu'ming'pin'ming'dian	0
欧露妮西娅	ou'lu'ni'xi'ya	0
欧鲁诺克	ou'lu'nuo'ke	0
欧鲁诺克的法术能量薯块	ou'lu'nuo'ke'de'fa'shu'neng'liang'shu'kuai	0
欧鲁诺克的伙伴	ou'lu'nuo'ke'de'huo'ban	0
欧鲁诺克的旧护腿	ou'lu'nuo'ke'de'jiu'hu'tui	0
欧鲁诺克的旧护腕	ou'lu'nuo'ke'de'jiu'hu'wan	0
欧鲁诺克的力量薯块	ou'lu'nuo'ke'de'li'liang'shu'kuai	0
欧鲁诺克的敏捷薯块	ou'lu'nuo'ke'de'min'jie'shu'kuai	0
欧鲁诺克的上古权杖	ou'lu'nuo'ke'de'shang'gu'quan'zhang	0
欧鲁诺克的野猪哨	ou'lu'nuo'ke'de'ye'zhu'shao	0
欧鲁诺克的治疗薯块	ou'lu'nuo'ke'de'zhi'liao'shu'kuai	0
欧鲁诺克农场	ou'lu'nuo'ke'nong'chang	0
欧陆情	ou'lu'qing	0
欧陆情壁炉	ou'lu'qing'bi'lu	0
欧陆情大衣柜	ou'lu'qing'da'yi'gui	0
欧路莎	ou'lu'sha	0
欧路莎卫浴	ou'lu'sha'wei'yu	0
欧陆商城	ou'lu'shang'cheng	0
欧陆商务酒店	ou'lu'shang'wu'jiu'dian	0
鸥鹭稍回青霭外	ou'lu'shao'hui'qing'ai'wai	0
欧鹿生活城	ou'lu'sheng'huo'cheng	0
欧陆私	ou'lu'si	0
欧陆私厨	ou'lu'si'chu	0
欧露索拉	ou'lu'suo'la	0
欧陆天使	ou'lu'tian'shi	0
欧陆铁艺	ou'lu'tie'yi	0
欧陆通	ou'lu'tong	0
鸥鹭宛停峙	ou'lu'wan'ting'zhi	0
欧陆忘机	ou'lu'wang'ji	0
鸥鹭忘机	ou'lu'wang'ji	0
鸥鹭往来驯	ou'lu'wang'lai'xun	0
鸥鹭为舟	ou'lu'wei'zhou	0
鸥鹭下烟中	ou'lu'xia'yan'zhong	0
鸥鹭闲眠	ou'lu'xian'mian	0
欧陆小	ou'lu'xiao	0
欧陆小馆	ou'lu'xiao'guan	0
欧陆鞋城	ou'lu'xie'cheng	0
欧陆行	ou'lu'xing	0
欧陆眼镜	ou'lu'yan'jing	0
偶录于抗风轩之南	ou'lu'yu'kang'feng'xuan'zhi'nan	0
欧陆园	ou'lu'yuan	0
欧陆苑	ou'lu'yuan	0
鸥鹭元相得	ou'lu'yuan'xiang'de	0
欧陆众筹	ou'lu'zhong'chou	0
欧伦	ou'lun	0
欧轮	ou'lun	0
欧伦花园	ou'lun'hua'yuan	0
欧伦花园别墅	ou'lun'hua'yuan'bie'shu	0
欧伦咖	ou'lun'ka	0
欧伦咖啡	ou'lun'ka'fei	0
欧伦咖啡吧	ou'lun'ka'fei'ba	0
欧伦姆斯	ou'lun'mu'si	0
欧伦依	ou'lun'yi	0
欧罗	ou'luo	0
藕萝	ou'luo	0
欧罗吧	ou'luo'ba	0
欧罗巴	ou'luo'ba	0
欧罗芭	ou'luo'ba	0
欧罗巴报告	ou'luo'ba'bao'gao	0
欧罗巴北	ou'luo'ba'bei	0
欧罗巴北行店	ou'luo'ba'bei'xing'dian	0
欧罗吧茶	ou'luo'ba'cha	0
欧罗吧茶楼	ou'luo'ba'cha'lou	0
欧罗巴长	ou'luo'ba'chang	0
欧罗巴长江路店	ou'luo'ba'chang'jiang'lu'dian	0
欧罗巴的年夜饭	ou'luo'ba'de'nian'ye'fan	0
欧罗巴桂	ou'luo'ba'gui	0
欧罗巴桂林路店	ou'luo'ba'gui'lin'lu'dian	0
欧罗巴黑	ou'luo'ba'hei	0
欧罗巴红	ou'luo'ba'hong	0
欧罗巴蓝	ou'luo'ba'lan	0
欧罗巴联邦	ou'luo'ba'lian'bang	0
欧罗巴年鉴	ou'luo'ba'nian'jian	0
欧罗巴欧罗巴	ou'luo'ba'ou'luo'ba	0
欧罗吧啤	ou'luo'ba'pi	0
欧罗吧啤酒广场	ou'luo'ba'pi'jiu'guang'chang	0
欧罗巴清	ou'luo'ba'qing	0
欧罗巴清明街店	ou'luo'ba'qing'ming'jie'dian	0
欧罗巴三	ou'luo'ba'san	0
欧罗巴三好街店	ou'luo'ba'san'hao'jie'dian	0
欧罗巴世界乐园	ou'luo'ba'shi'jie'le'yuan	0
欧罗巴太	ou'luo'ba'tai	0
欧罗巴太原街店	ou'luo'ba'tai'yuan'jie'dian	0
欧罗巴同	ou'luo'ba'tong	0
欧罗巴同志街店	ou'luo'ba'tong'zhi'jie'dian	0
欧罗巴西餐厅	ou'luo'ba'xi'can'ting	0
欧罗巴小镇	ou'luo'ba'xiao'zhen	0
欧罗巴休	ou'luo'ba'xiu	0
欧罗巴休闲	ou'luo'ba'xiu'xian	0
欧罗巴中	ou'luo'ba'zhong	0
欧罗巴中街店	ou'luo'ba'zhong'jie'dian	0
欧罗巴棕	ou'luo'ba'zong	0
欧罗布尔山洞	ou'luo'bu'er'shan'dong	0
欧洛丹	ou'luo'dan	0
欧洛德那松	ou'luo'de'na'song	0
欧洛德瑞斯	ou'luo'de'rui'si	0
欧洛恩	ou'luo'en	0
欧洛法尔尼	ou'luo'fa'er'ni	0
偶落藩墙上	ou'luo'fan'qiang'shang	0
欧罗范图尔	ou'luo'fan'tu'er	0
欧洛斐尔	ou'luo'fei'er	0
欧洛芬	ou'luo'fen	0
欧罗家饰	ou'luo'jia'shi	0
欧罗咖	ou'luo'ka	0
欧罗咖啡	ou'luo'ka'fei	0
欧罗咖啡吴江路店	ou'luo'ka'fei'wu'jiang'lu'dian	0
欧洛卡尼	ou'luo'ka'ni	0
欧洛拉	ou'luo'la	0
欧罗拉公主	ou'luo'la'gong'zhu	0
欧罗拉公主的头饰	ou'luo'la'gong'zhu'de'tou'shi	0
欧罗拉克	ou'luo'la'ke	0
欧罗兰	ou'luo'lan	0
欧罗林	ou'luo'lin	0
欧罗曼	ou'luo'man	0
欧洛米	ou'luo'mi	0
欧洛米特	ou'luo'mi'te	0
欧罗妮厨柜	ou'luo'ni'chu'gui	0
欧罗佩	ou'luo'pei	0
欧洛浦肯	ou'luo'pu'ken	0
欧洛斯	ou'luo'si	0
欧洛塔斯	ou'luo'ta'si	0
欧洛仙得尔	ou'luo'xian'de'er	0
欧罗血眼	ou'luo'xue'yan	0
欧洛朱因	ou'luo'zhu'yin	0
欧律比亚	ou'lv'bi'ya	0
偶侣弄蝶属	ou'lv'nong'die'shu	0
欧律诺墨	ou'lv'nuo'mo	0
欧律诺摩斯	ou'lv'nuo'mo'si	0
欧律斯透斯	ou'lv'si'tou'si	0
欧玛	ou'ma	0
欧码	ou'ma	0
欧马	ou'ma	0
沤麻	ou'ma	0
鸥玛	ou'ma	0
欧麻痹	ou'ma'bi	0
沤麻池	ou'ma'chi	0
沤麻池水里	ou'ma'chi'shui'li	0
欧马德	ou'ma'de	0
欧码的不	ou'ma'de'bu	0
欧玛灯饰	ou'ma'deng'shi	0
欧玛尔	ou'ma'er	0
偶马尔科夫网络	ou'ma'er'ke'fu'wang'luo	0
欧玛嘉宝珠海开关设备有限公司	ou'ma'jia'bao'zhu'hai'kai'guan'she'bei'you'xian'gong'si	0
欧马可	ou'ma'ke	0
欧玛拉	ou'ma'la	0
欧玛丽	ou'ma'li	0
欧玛利	ou'ma'li	0
欧玛莉	ou'ma'li	0
欧玛利的仪器	ou'ma'li'de'yi'qi	0
欧玛丽中	ou'ma'li'zhong	0
沤麻入南涧	ou'ma'ru'nan'jian	0
欧玛亚管置入术	ou'ma'ya'guan'zhi'ru'shu	0
欧麻蝇属	ou'ma'ying'shu	0
欧脉	ou'mai	0
欧迈	ou'mai	0
欧麦	ou'mai	0
欧麦村	ou'mai'cun	0
欧麦德的机器	ou'mai'de'de'ji'qi	0
欧麦尔清真古寺	ou'mai'er'qing'zhen'gu'si	0
欧麦尔一世	ou'mai'er'yi'shi	0
偶买噶	ou'mai'ga	0
欧迈机械	ou'mai'ji'xie	0
欧麦咖	ou'mai'ka	0
欧麦咖啡	ou'mai'ka'fei	0
欧麦咖啡印度小厨	ou'mai'ka'fei'yin'du'xiao'chu	0
欧麦可	ou'mai'ke	0
欧麦可牛	ou'mai'ke'niu	0
欧麦可牛排	ou'mai'ke'niu'pai	0
欧麦勒	ou'mai'le	0
欧麦林	ou'mai'lin	0
欧麦林回	ou'mai'lin'hui	0
欧麦林回族鸭王府	ou'mai'lin'hui'zu'ya'wang'fu	0
欧麦尼	ou'mai'ni	0
欧麦尼外套	ou'mai'ni'wai'tao	0
欧麦司	ou'mai'si	0
欧麦香	ou'mai'xiang	0
欧曼	ou'man	0
欧曼车行	ou'man'che'hang	0
欧曼咖啡	ou'man'ka'fei	0
欧曼丽	ou'man'li	0
欧曼琳	ou'man'lin	0
欧曼尼	ou'man'ni	0
欧曼牌	ou'man'pai	0
欧曼汽车配件	ou'man'qi'che'pei'jian	0
欧曼图标	ou'man'tu'biao	0
欧曼陀罗	ou'man'tuo'luo	0
欧蔓纤丝	ou'man'xian'si	0
欧曼重型汽车厂	ou'man'zhong'xing'qi'che'chang	0
欧贸	ou'mao	0
殴毛蝇	ou'mao'ying	0
欧梅	ou'mei	0
欧美	ou'mei	0
藕煤	ou'mei	0
欧美背心男	ou'mei'bei'xin'nan	0
欧美宾馆	ou'mei'bin'guan	0
欧美潮牌外套	ou'mei'chao'pai'wai'tao	0
欧美车	ou'mei'che	0
欧美达	ou'mei'da	0
欧美大牌	ou'mei'da'pai	0
欧美大牌体恤衫	ou'mei'da'pai'ti'xu'shan	0
欧美单	ou'mei'dan	0
欧美电视剧	ou'mei'dian'shi'ju	0
欧美短袖男	ou'mei'duan'xiu'nan	0
欧美尔	ou'mei'er	0
欧美尔洁具	ou'mei'er'jie'ju	0
欧美范	ou'mei'fan	0
欧美风	ou'mei'feng	0
欧美风格秋冬棉衣	ou'mei'feng'ge'qiu'dong'mian'yi	0
欧美风情	ou'mei'feng'qing	0
欧美风情小镇	ou'mei'feng'qing'xiao'zhen	0
欧美服饰	ou'mei'fu'shi	0
欧美格	ou'mei'ge	0
欧美格调	ou'mei'ge'diao	0
欧美个性马丁靴男	ou'mei'ge'xing'ma'ding'xue'nan	0
欧美工业园	ou'mei'gong'ye'yuan	0
欧美购	ou'mei'gou	0
欧美股市	ou'mei'gu'shi	0
欧美航空公司	ou'mei'hang'kong'gong'si	0
欧美汇	ou'mei'hui	0
欧美家	ou'mei'jia	0
欧美佳傲骏	ou'mei'jia'ao'jun	0
欧美佳橱柜	ou'mei'jia'chu'gui	0
欧美家具	ou'mei'jia'ju	0
欧美佳苑	ou'mei'jia'yuan	0
欧美家园	ou'mei'jia'yuan	0
欧美加战机	ou'mei'jia'zhan'ji	0
欧美简约	ou'mei'jian'yue	0
欧美街头卫衣	ou'mei'jie'tou'wei'yi	0
欧美经典夹克	ou'mei'jing'dian'jia'ke	0
欧美康	ou'mei'kang	0
欧美科技苑	ou'mei'ke'ji'yuan	0
欧美克科技	ou'mei'ke'ke'ji	0
欧美款	ou'mei'kuan	0
欧美明星	ou'mei'ming'xing	0
欧美男街拍小脚九分潮	ou'mei'nan'jie'pai'xiao'jiao'jiu'fen'chao	0
欧美难题	ou'mei'nan'ti	0
欧美宁	ou'mei'ning	0
欧美排行榜	ou'mei'pai'hang'bang	0
欧美盘叠加盈利模式	ou'mei'pan'die'jia'ying'li'mo'shi	0
欧美墙纸	ou'mei'qiang'zhi	0
欧美塞尔	ou'mei'sai'er	0
欧魅赛尔	ou'mei'sai'er	0
欧美散白蚁	ou'mei'san'bai'yi	0
欧美色图片	ou'mei'se'tu'pian	0
欧美尚	ou'mei'shang	0
欧美摄影	ou'mei'she'ying	0
欧美仕	ou'mei'shi	0
欧美市场	ou'mei'shi'chang	0
欧美斯	ou'mei'si	0
欧美陶瓷	ou'mei'tao'ci	0
欧美特	ou'mei'te	0
欧美特糕	ou'mei'te'gao	0
欧美特糕点店	ou'mei'te'gao'dian'dian	0
欧美天堂	ou'mei'tian'tang	0
欧美铁艺	ou'mei'tie'yi	0
欧美同学会	ou'mei'tong'xue'hui	0
欧美外贸尾单男	ou'mei'wai'mao'wei'dan'nan	0
欧美外套男潮街头	ou'mei'wai'tao'nan'chao'jie'tou	0
欧美丸子头	ou'mei'wan'zi'tou	0
欧美嘻哈短袖	ou'mei'xi'ha'duan'xiu	0
欧美嘻哈裤子	ou'mei'xi'ha'ku'zi	0
欧美嘻哈套装	ou'mei'xi'ha'tao'zhuang	0
欧美嘻哈外套	ou'mei'xi'ha'wai'tao	0
欧美嘻哈外套冬季	ou'mei'xi'ha'wai'tao'dong'ji	0
欧美嘻哈外套男	ou'mei'xi'ha'wai'tao'nan	0
欧美嘻哈外套男潮牌	ou'mei'xi'ha'wai'tao'nan'chao'pai	0
欧美嘻哈卫衣	ou'mei'xi'ha'wei'yi	0
欧美西裤男	ou'mei'xi'ku'nan	0
欧美系列	ou'mei'xi'lie	0
欧美西装男	ou'mei'xi'zhuang'nan	0
欧美香	ou'mei'xiang	0
欧美小镇	ou'mei'xiao'zhen	0
欧美学院	ou'mei'xue'yuan	0
欧美亚	ou'mei'ya	0
欧美亚东门	ou'mei'ya'dong'men	0
欧美雅口腔	ou'mei'ya'kou'qiang	0
欧美亚汽车城	ou'mei'ya'qi'che'cheng	0
欧美亚世界阳光	ou'mei'ya'shi'jie'yang'guang	0
欧美亚世界阳光东门	ou'mei'ya'shi'jie'yang'guang'dong'men	0
欧美亚世界阳光南门	ou'mei'ya'shi'jie'yang'guang'nan'men	0
欧美亚西门	ou'mei'ya'xi'men	0
欧美药妆	ou'mei'yao'zhuang	0
鸥美药妆	ou'mei'yao'zhuang	0
欧美羽绒服	ou'mei'yu'rong'fu	0
欧美羽绒服女	ou'mei'yu'rong'fu'nv	0
欧美苑	ou'mei'yuan	0
欧美原单	ou'mei'yuan'dan	0
欧美植物区	ou'mei'zhi'wu'qu	0
欧美植物群	ou'mei'zhi'wu'qun	0
欧美中心	ou'mei'zhong'xin	0
欧美装饰	ou'mei'zhuang'shi	0
欧梅组	ou'mei'zu	0
欧们	ou'men	0
欧门	ou'men	0
偶们随时	ou'men'sui'shi	0
偶们学校	ou'men'xue'xiao	0
欧梦	ou'meng	0
欧盟	ou'meng	0
欧盟餐酒	ou'meng'can'jiu	0
偶蒙春风荣	ou'meng'chun'feng'rong	0
欧梦达	ou'meng'da	0
偶蒙东风荣	ou'meng'dong'feng'rong	0
欧盟对华	ou'meng'dui'hua	0
欧盟法	ou'meng'fa	0
欧盟法院	ou'meng'fa'yuan	0
欧盟风云	ou'meng'feng'yun	0
欧盟工业园	ou'meng'gong'ye'yuan	0
欧盟工业园黄楼	ou'meng'gong'ye'yuan'huang'lou	0
欧盟黑暗议会	ou'meng'hei'an'yi'hui	0
欧盟内部审计师协会联合会	ou'meng'nei'bu'shen'ji'shi'xie'hui'lian'he'hui	0
欧盟批号	ou'meng'pi'hao	0
欧盟委员会	ou'meng'wei'yuan'hui	0
欧盟委员会主席	ou'meng'wei'yuan'hui'zhu'xi	0
欧盟一号	ou'meng'yi'hao	0
欧盟总统	ou'meng'zong'tong	0
偶觅	ou'mi	0
欧米	ou'mi	0
欧米德	ou'mi'de	0
欧米伽	ou'mi'ga	0
欧米噶	ou'mi'ga	0
欧米伽符文	ou'mi'ga'fu'wen	0
欧密格	ou'mi'ge	0
欧米佳	ou'mi'jia	0
欧米茄	ou'mi'jia	0
欧米茄防御者	ou'mi'jia'fang'yu'zhe	0
欧米茄毁灭者	ou'mi'jia'hui'mie'zhe	0
欧米茄火炮	ou'mi'jia'huo'pao	0
欧米茄级变种人	ou'mi'jia'ji'bian'zhong'ren	0
欧米茄灵能者	ou'mi'jia'ling'neng'zhe	0
欧米茄零式时空狭缝阿尔法幻境	ou'mi'jia'ling'shi'shi'kong'xia'feng'a'er'fa'huan'jing	0
欧米茄零式时空狭缝德尔塔幻境	ou'mi'jia'ling'shi'shi'kong'xia'feng'de'er'ta'huan'jing	0
欧米茄零式时空狭缝西格玛幻境	ou'mi'jia'ling'shi'shi'kong'xia'feng'xi'ge'ma'huan'jing	0
欧米茄旗舰店	ou'mi'jia'qi'jian'dian	0
欧米茄时空狭缝阿尔法幻境	ou'mi'jia'shi'kong'xia'feng'a'er'fa'huan'jing	0
欧米茄时空狭缝德尔塔幻境	ou'mi'jia'shi'kong'xia'feng'de'er'ta'huan'jing	0
欧米茄时空狭缝西格玛幻境	ou'mi'jia'shi'kong'xia'feng'xi'ge'ma'huan'jing	0
欧米茄探员	ou'mi'jia'tan'yuan	0
欧米茄形态	ou'mi'jia'xing'tai	0
欧米茄医护兵	ou'mi'jia'yi'hu'bing	0
欧米茄装配	ou'mi'jia'zhuang'pei	0
欧米加姿态	ou'mi'jia'zi'tai	0
欧米皮具	ou'mi'pi'ju	0
欧米奇	ou'mi'qi	0
欧米奇咖	ou'mi'qi'ka	0
欧米奇咖啡西餐	ou'mi'qi'ka'fei'xi'can	0
欧密茄防御者	ou'mi'qie'fang'yu'zhe	0
欧密茄灵能者	ou'mi'qie'ling'neng'zhe	0
欧密茄探员	ou'mi'qie'tan'yuan	0
欧密茄医护兵	ou'mi'qie'yi'hu'bing	0
欧密茄装配	ou'mi'qie'zhuang'pei	0
欧米斯特	ou'mi'si'te	0
偶面壁	ou'mian'bi	0
鸥眠春风暖日	ou'mian'chun'feng'nuan'ri	0
欧绵马	ou'mian'ma	0
鸥眠起水惊	ou'mian'qi'shui'jing	0
偶面试	ou'mian'shi	0
欧庙	ou'miao	0
欧庙村	ou'miao'cun	0
欧庙镇	ou'miao'zhen	0
欧敏	ou'min	0
欧旻厂	ou'min'chang	0
瓯闽两邦士	ou'min'liang'bang'shi	0
瓯闽適少宽	ou'min'shi'shao'kuan	0
欧皿蛛属	ou'min'zhu'shu	0
欧螟点缘跳小蜂	ou'ming'dian'yuan'tiao'xiao'feng	0
沤名声	ou'ming'sheng	0
偶摸	ou'mo	0
偶模	ou'mo	0
欧模	ou'mo	0
沤沫槿艳	ou'mo'jin'yan	0
欧莫克	ou'mo'ke	0
欧莫克大王	ou'mo'ke'da'wang	0
欧莫克的瘦身腰带	ou'mo'ke'de'shou'shen'yao'dai	0
欧莫克的头颅	ou'mo'ke'de'tou'lu	0
欧莫克之拳	ou'mo'ke'zhi'quan	0
偶莫名	ou'mo'ming	0
欧墨尼得斯	ou'mo'ni'de'si	0
欧亩	ou'mu	0
欧姆	ou'mu	0
欧母	ou'mu	0
欧姆贝	ou'mu'bei	0
欧姆贝亚目	ou'mu'bei'ya'mu	0
欧姆表	ou'mu'biao	0
欧姆档	ou'mu'dang	0
欧姆电压降	ou'mu'dian'ya'jiang	0
欧姆定律	ou'mu'ding'lv	0
欧姆定律成正比	ou'mu'ding'lv'cheng'zheng'bi	0
欧姆计	ou'mu'ji	0
欧姆加热	ou'mu'jia're	0
欧姆接触	ou'mu'jie'chu	0
欧姆接点	ou'mu'jie'dian	0
欧姆控制	ou'mu'kong'zhi	0
欧姆龙	ou'mu'long	0
欧姆龙大连有限公司	ou'mu'long'da'lian'you'xian'gong'si	0
欧姆龙公司	ou'mu'long'gong'si	0
欧姆龙工业区	ou'mu'long'gong'ye'qu	0
欧姆龙工业园	ou'mu'long'gong'ye'yuan	0
欧姆龙继电器	ou'mu'long'ji'dian'qi	0
欧姆龙血压计	ou'mu'long'xue'ya'ji	0
欧姆龙站	ou'mu'long'zhan	0
欧姆龙专卖店	ou'mu'long'zhuan'mai'dian	0
欧木门	ou'mu'men	0
欧姆耦合变压器	ou'mu'ou'he'bian'ya'qi	0
欧姆萨	ou'mu'sa	0
欧姆收信机	ou'mu'shou'xin'ji	0
欧姆损耗	ou'mu'sun'hao	0
欧姆阻抗	ou'mu'zu'kang	0
偶娜	ou'na	0
欧拿	ou'na	0
欧纳	ou'na	0
欧娜达	ou'na'da	0
欧纳菲	ou'na'fei	0
欧拿蒙	ou'na'meng	0
欧纳泽尔	ou'na'ze'er	0
呕奶	ou'nai	0
欧耐	ou'nai	0
欧乃派克	ou'nai'pai'ke	0
欧乃派克注射液	ou'nai'pai'ke'zhu'she'ye	0
欧耐特	ou'nai'te	0
欧乃影	ou'nai'ying	0
欧乃影注射液	ou'nai'ying'zhu'she'ye	0
呕男	ou'nan	0
欧南	ou'nan	0
瓯南大桥	ou'nan'da'qiao	0
瓯南大厦	ou'nan'da'sha	0
欧南多	ou'nan'duo	0
欧南家园	ou'nan'jia'yuan	0
瓯南街道	ou'nan'jie'dao	0
欧南台	ou'nan'tai	0
欧南杏	ou'nan'xing	0
瓯南医药	ou'nan'yi'yao	0
欧南园	ou'nan'yuan	0
欧囊	ou'nang	0
欧内	ou'nei	0
藕内	ou'nei	0
欧内斯特	ou'nei'si'te	0
欧内斯特海明威	ou'nei'si'te'hai'ming'wei	0
欧能	ou'neng	0
偶能产生过敏反应	ou'neng'chan'sheng'guo'min'fan'ying	0
欧能防腐储存柜	ou'neng'fang'fu'chu'cun'gui	0
偶你	ou'ni	0
呕泥	ou'ni	0
呕逆	ou'ni	0
欧尼	ou'ni	0
欧霓	ou'ni	0
欧尼奥	ou'ni'ao	0
欧尼大头蚁	ou'ni'da'tou'yi	0
欧尼迪	ou'ni'di	0
欧尼迩	ou'ni'er	0
藕泥封藕节	ou'ni'feng'ou'jie	0
欧妮服装设计中心	ou'ni'fu'zhuang'she'ji'zhong'xin	0
欧尼酱	ou'ni'jiang	0
欧尼丽	ou'ni'li	0
欧尼士	ou'ni'shi	0
欧尼斯	ou'ni'si	0
欧尼斯大神官	ou'ni'si'da'shen'guan	0
欧尼斯矿物商人	ou'ni'si'kuang'wu'shang'ren	0
欧尼斯特	ou'ni'si'te	0
藕泥塘	ou'ni'tang	0
欧尼瓦营地	ou'ni'wa'ying'di	0
欧尼希兹的酷行	ou'ni'xi'zi'de'ku'xing	0
欧尼雅服饰	ou'ni'ya'fu'shi	0
欧尼亚米斯之翼	ou'ni'ya'mi'si'zhi'yi	0
呕逆躁烦	ou'ni'zao'fan	0
欧鲶引进	ou'nian'yin'jin	0
沤鸟	ou'niao	0
鸥鸟傍神仙	ou'niao'bang'shen'xian	0
鸥鸟不下	ou'niao'bu'xia	0
鸥鸟共忘年	ou'niao'gong'wang'nian	0
鸥鸟蒹葭成四邻	ou'niao'jian'jia'cheng'si'lin	0
鸥鸟镜里来	ou'niao'jing'li'lai	0
鸥鸟恋为群	ou'niao'lian'wei'qun	0
鸥鸟暮群群	ou'niao'mu'qun'qun	0
鸥鸟牵丝飏	ou'niao'qian'si'yang	0
鸥鸟识归心	ou'niao'shi'gui'xin	0
鸥鸟世情赊	ou'niao'shi'qing'she	0
鸥鸟忘机	ou'niao'wang'ji	0
鸥鸟忘机翻浃洽	ou'niao'wang'ji'fan'jia'qia	0
鸥鸟兮与之游	ou'niao'xi'yu'zhi'you	0
鸥鸟相与嬉	ou'niao'xiang'yu'xi	0
鸥鸟也欺人	ou'niao'ye'qi'ren	0
鸥鸟亦来下	ou'niao'yi'lai'xia	0
鸥鸟一双随坐啸	ou'niao'yi'shuang'sui'zuo'xiao	0
鸥鸟一双随坐笑	ou'niao'yi'shuang'sui'zuo'xiao	0
鸥鸟亦依依	ou'niao'yi'yi'yi	0
鸥鸟亦知人意静	ou'niao'yi'zhi'ren'yi'jing	0
鸥鸟恣浮沉	ou'niao'zi'fu'chen	0
鸥鸟自为群	ou'niao'zi'wei'qun	0
欧宁	ou'ning	0
瓯凝碧玉泥	ou'ning'bi'yu'ni	0
鸥凝结	ou'ning'jie	0
瓯宁街道	ou'ning'jie'dao	0
偶宁乡	ou'ning'xiang	0
欧浓	ou'nong	0
讴弄蝶属	ou'nong'die'shu	0
呕脓尽自愈	ou'nong'jin'zi'yu	0
欧浓咖	ou'nong'ka	0
欧浓咖啡	ou'nong'ka'fei	0
欧努阿库	ou'nu'a'ku	0
欧诺	ou'nuo	0
欧诺齿科	ou'nuo'chi'ke	0
欧诺德	ou'nuo'de	0
欧诺德罗河	ou'nuo'de'luo'he	0
欧诺德民	ou'nuo'de'min	0
欧诺个像	ou'nuo'ge'xiang	0
欧诺曼	ou'nuo'man	0
欧诺漫	ou'nuo'man	0
欧诺弥亚	ou'nuo'mi'ya	0
欧诺尼亚	ou'nuo'ni'ya	0
欧诺特	ou'nuo'te	0
偶女	ou'nv	0
欧噢大神	ou'o'da'shen	0
偶哦哦	ou'o'o	0
藕藕	ou'ou	0
謳謳	ou'ou	0
偶偶好几年了	ou'ou'hao'ji'nian'le	0
偶偶核	ou'ou'he	0
謳謳向	ou'ou'xiang	0
呕呕轧轧	ou'ou'ya'ya	0
欧帕	ou'pa	0
歐趴	ou'pa	0
鸥怕鼓难驯	ou'pa'gu'nan'xun	0
欧帕尼	ou'pa'ni	0
偶怕人看天后	ou'pa'ren'kan'tian'hou	0
欧帕之光	ou'pa'zhi'guang	0
欧派	ou'pai	0
欧派厨柜	ou'pai'chu'gui	0
欧派橱柜	ou'pai'chu'gui	0
欧派厨卫	ou'pai'chu'wei	0
欧派服饰	ou'pai'fu'shi	0
欧派家纺	ou'pai'jia'fang	0
欧派家居	ou'pai'jia'ju	0
欧派金帝	ou'pai'jin'di	0
欧派克	ou'pai'ke	0
欧派鲤	ou'pai'li	0
欧派罗	ou'pai'luo	0
欧派企业	ou'pai'qi'ye	0
欧派塔	ou'pai'ta	0
欧派特	ou'pai'te	0
欧派卫浴	ou'pai'wei'yu	0
欧派整体厨柜	ou'pai'zheng'ti'chu'gui	0
欧派整体橱柜	ou'pai'zheng'ti'chu'gui	0
欧派整体卫浴	ou'pai'zheng'ti'wei'yu	0
欧盘村	ou'pan'cun	0
偶攀黄黄柳	ou'pan'huang'huang'liu	0
偶攀杨枝柳	ou'pan'yang'zhi'liu	0
呕泡	ou'pao	0
偶配	ou'pei	0
欧佩克	ou'pei'ke	0
欧佩克各国	ou'pei'ke'ge'guo	0
欧佩克主席	ou'pei'ke'zhu'xi	0
欧佩拉	ou'pei'la	0
欧培拉	ou'pei'la	0
欧培拉小熊	ou'pei'la'xiao'xiong	0
欧喷爱	ou'pen'ai	0
欧彭	ou'peng	0
欧鹏	ou'peng	0
鸥鹏酒店	ou'peng'jiu'dian	0
欧皮	ou'pi	0
偶偏	ou'pian	0
藕片	ou'pian	0
藕片炭	ou'pian'tan	0
藕片汤	ou'pian'tang	0
藕片糖	ou'pian'tang	0
欧飘鱼	ou'piao'yu	0
偶撇	ou'pie	0
欧品	ou'pin	0
欧品橱柜	ou'pin'chu'gui	0
欧品橱柜广场	ou'pin'chu'gui'guang'chang	0
欧品蛋糕	ou'pin'dan'gao	0
欧品行	ou'pin'xing	0
欧平	ou'ping	0
偶凭窗扉从落照	ou'ping'chuang'fei'cong'luo'zhao	0
欧屏赣	ou'ping'gan	0
偶婆	ou'po	0
欧坡	ou'po	0
欧珀	ou'po	0
欧坡村	ou'po'cun	0
欧珀莱	ou'po'lai	0
欧珀特	ou'po'te	0
欧珀雅	ou'po'ya	0
欧扑	ou'pu	0
欧普	ou'pu	0
欧浦	ou'pu	0
瓯浦	ou'pu	0
欧普橱柜	ou'pu'chu'gui	0
欧普灯饰	ou'pu'deng'shi	0
欧浦电子盘	ou'pu'dian'zi'pan	0
欧普定	ou'pu'ding	0
欧浦钢网	ou'pu'gang'wang	0
欧普公司	ou'pu'gong'si	0
欧普光学	ou'pu'guang'xue	0
欧普豪华灯饰城	ou'pu'hao'hua'deng'shi'cheng	0
欧普康视	ou'pu'kang'shi	0
欧普康视科技有限公司	ou'pu'kang'shi'ke'ji'you'xian'gong'si	0
欧普拉	ou'pu'la	0
欧普利	ou'pu'li	0
欧普林特鲁实蝇	ou'pu'lin'te'lu'shi'ying	0
欧普泰	ou'pu'tai	0
欧普特蒙	ou'pu'te'meng	0
瓯浦土羊	ou'pu'tu'yang	0
鸥浦乡	ou'pu'xiang	0
瓯浦垟	ou'pu'yang	0
瓯浦垟口	ou'pu'yang'kou	0
欧普艺术床单四件套	ou'pu'yi'shu'chuang'dan'si'jian'tao	0
欧普照明	ou'pu'zhao'ming	0
欧浦智网	ou'pu'zhi'wang	0
欧普主义	ou'pu'zhu'yi	0
欧普专卖店	ou'pu'zhuan'mai'dian	0
偶企	ou'qi	0
呕气	ou'qi	0
怄气	ou'qi	0
欧奇	ou'qi	0
欧琪	ou'qi	0
偶憩池头最小亭	ou'qi'chi'tou'zui'xiao'ting	0
鸥起复谁惊	ou'qi'fu'shui'jing	0
偶奇核	ou'qi'he	0
怄气了	ou'qi'le	0
偶其类	ou'qi'lei	0
欧七欧八	ou'qi'ou'ba	0
鸥栖心恋水	ou'qi'xin'lian'shui	0
欧钱餐厅	ou'qian'can'ting	0
欧前胡素	ou'qian'hu'su	0
欧荨麻	ou'qian'ma	0
偶前天	ou'qian'tian	0
欧倩怡	ou'qian'yi	0
欧腔	ou'qiang	0
欧桥	ou'qiao	0
欧桥村	ou'qiao'cun	0
欧且	ou'qie	0
欧芹	ou'qin	0
欧芹精华	ou'qin'jing'hua	0
欧芹属	ou'qin'shu	0
欧青	ou'qing	0
欧情茨	ou'qing'ci	0
鸥轻故不还	ou'qing'gu'bu'hai	0
鸥轻故不还	ou'qing'gu'bu'huan	0
欧情海景园	ou'qing'hai'jing'yuan	0
欧青山	ou'qing'shan	0
欧清石	ou'qing'shi	0
偶擎桐叶	ou'qing'tong'ye	0
瓯倾锡水散凝酥	ou'qing'xi'shui'san'ning'su	0
鸥轻欲问铢	ou'qing'yu'wen'zhu	0
鸥情转自縻	ou'qing'zhuan'zi'mi	0
欧琼	ou'qiong	0
欧琼的伐木场传送点	ou'qiong'de'fa'mu'chang'chuan'song'dian	0
欧曲	ou'qu	0
殴佢	ou'qu	0
瓯渠	ou'qu	0
藕渠	ou'qu	0
欧曲达摩巴札	ou'qu'da'mo'ba'zha	0
偶去非吾穷	ou'qu'fei'wu'qiong	0
呕去感掉	ou'qu'gan'diao	0
藕渠加油站	ou'qu'jia'you'zhan	0
偶去玛驰	ou'qu'ma'chi	0
偶取一卷披	ou'qu'yi'juan'pi	0
藕渠镇	ou'qu'zhen	0
藕渠中学	ou'qu'zhong'xue	0
欧全	ou'quan	0
欧泉	ou'quan	0
欧泉美	ou'quan'mei	0
欧泉美容	ou'quan'mei'rong	0
偶雀	ou'que	0
偶染	ou'ran	0
偶然	ou'ran	0
偶然爱之不能去	ou'ran'ai'zhi'bu'neng'qu	0
偶然把酒叶公城	ou'ran'ba'jiu'ye'gong'cheng	0
偶然曝光	ou'ran'bao'guang	0
偶然毕命网罗	ou'ran'bi'ming'wang'luo	0
偶然变异	ou'ran'bian'yi	0
偶然不到终遗恨	ou'ran'bu'dao'zhong'yi'hen	0
偶然不施用	ou'ran'bu'shi'yong	0
偶然草	ou'ran'cao	0
偶然乘兴	ou'ran'cheng'xing	0
偶然乘兴便醺醺	ou'ran'cheng'xing'bian'xun'xun	0
偶然成一笑	ou'ran'cheng'yi'xiao	0
偶然重合	ou'ran'chong'he	0
偶然存蔗芋	ou'ran'cun'zhe'yu	0
偶然的	ou'ran'de	0
偶然得空壁	ou'ran'de'kong'bi	0
偶然得老尉	ou'ran'de'lao'wei	0
偶然的两度重逢	ou'ran'de'liang'du'chong'feng	0
偶然的旅行	ou'ran'de'lv'xing	0
偶然的相遇	ou'ran'de'xiang'yu	0
偶然得一饱	ou'ran'de'yi'bao	0
偶然得意挹珍流	ou'ran'de'yi'yi'zhen'liu	0
偶然的一致	ou'ran'de'yi'zhi	0
偶然得幽致	ou'ran'de'you'zhi	0
偶然得之	ou'ran'de'zhi	0
偶然二首	ou'ran'er'shou	0
偶然反射	ou'ran'fan'she	0
偶然分布	ou'ran'fen'bu	0
偶染风寒	ou'ran'feng'han	0
偶然逢客子	ou'ran'feng'ke'zi	0
偶然符合	ou'ran'fu'he	0
偶然公开	ou'ran'gong'kai	0
偶然共栖	ou'ran'gong'qi	0
偶然沽市酒	ou'ran'gu'shi'jiu	0
偶然挂壁低头笑	ou'ran'gua'bi'di'tou'xiao	0
偶然荷载	ou'ran'he'zai	0
偶然画出寻诗意	ou'ran'hua'chu'xun'shi'yi	0
偶然回首来时路	ou'ran'hui'shou'lai'shi'lu	0
偶然间	ou'ran'jian	0
偶然间不论姑娘	ou'ran'jian'bu'lun'gu'niang	0
偶然见你病了	ou'ran'jian'ni'bing'le	0
偶然交已深	ou'ran'jiao'yi'shen	0
偶然结婚	ou'ran'jie'hun	0
偶然尽室载孤舟	ou'ran'jin'shi'zai'gu'zhou	0
偶然客至话乡国	ou'ran'ke'zhi'hua'xiang'guo	0
偶然来过何年复	ou'ran'lai'guo'he'nian'fu	0
偶然连了宗的	ou'ran'lian'le'zong'de	0
偶然连六鳌	ou'ran'lian'liu'ao	0
偶然两句吹到耳内	ou'ran'liang'ju'chui'dao'er'nei	0
偶然领会一谈胜	ou'ran'ling'hui'yi'tan'sheng	0
偶然路过的街	ou'ran'lu'guo'de'jie	0
偶然路过的人灵	ou'ran'lu'guo'de'ren'ling	0
偶然偏心	ou'ran'pian'xin	0
偶然岂定期	ou'ran'qi'ding'qi	0
偶然弃官去	ou'ran'qi'guan'qu	0
偶然起了个念头	ou'ran'qi'le'ge'nian'tou	0
偶然倾盖接清言	ou'ran'qing'gai'jie'qing'yan	0
偶然青衫五斗米	ou'ran'qing'shan'wu'dou'mi	0
偶然群	ou'ran'qun	0
偶然如一唾	ou'ran'ru'yi'tuo	0
偶然事故	ou'ran'shi'gu	0
偶然事件	ou'ran'shi'jian	0
偶然失效期	ou'ran'shi'xiao'qi	0
偶然思玉仙	ou'ran'si'yu'xian	0
偶然所得	ou'ran'suo'de	0
偶然谈笑得佳篇	ou'ran'tan'xiao'de'jia'pian	0
偶然体	ou'ran'ti	0
偶然同化作用	ou'ran'tong'hua'zuo'yong	0
偶然同我西掖垣	ou'ran'tong'wo'xi'ye'yuan	0
偶然退化	ou'ran'tui'hua	0
偶然忘记了	ou'ran'wang'ji'le	0
偶然威胁	ou'ran'wei'xie	0
偶然闻雨落阶除	ou'ran'wen'yu'luo'jie'chu	0
偶然误差	ou'ran'wu'cha	0
偶然相遇人间世	ou'ran'xiang'yu'ren'jian'shi	0
偶然相值两浮萍	ou'ran'xiang'zhi'liang'fu'ping	0
偶然信马及余瓢	ou'ran'xin'ma'ji'yu'piao	0
偶然信手皆虚击	ou'ran'xin'shou'jie'xu'ji	0
偶然性	ou'ran'xing	0
偶然性浮游生物	ou'ran'xing'fu'you'sheng'wu	0
偶然性情节	ou'ran'xing'qing'jie	0
偶然性音乐	ou'ran'xing'yin'yue	0
偶然学习	ou'ran'xue'xi	0
偶然寻绎尚能存	ou'ran'xun'yi'shang'neng'cun	0
偶然芽变	ou'ran'ya'bian	0
偶然雅集百乐齐鸣	ou'ran'ya'ji'bai'le'qi'ming	0
偶然一次的傻等	ou'ran'yi'ci'de'sha'deng	0
偶然一次睡迟了些	ou'ran'yi'ci'shui'chi'le'xie	0
偶然一掉犹思堑	ou'ran'yi'diao'you'si'qian	0
偶然一看	ou'ran'yi'kan	0
偶然一念堕世网	ou'ran'yi'nian'duo'shi'wang	0
偶然因果关系	ou'ran'yin'guo'guan'xi	0
偶然音乐	ou'ran'yin'yue	0
偶然有不通方言的	ou'ran'you'bu'tong'fang'yan'de	0
偶然与必然	ou'ran'yu'bi'ran	0
偶然运气	ou'ran'yun'qi	0
偶然沾带了些	ou'ran'zhan'dai'le'xie	0
偶然占先	ou'ran'zhan'xian	0
偶然治瘥一病	ou'ran'zhi'chai'yi'bing	0
偶然直堕湖中水	ou'ran'zhi'duo'hu'zhong'shui	0
偶然值林叟	ou'ran'zhi'lin'sou	0
偶然值林叟谈笑无还期	ou'ran'zhi'lin'sou'tan'xiao'wu'hai'qi	0
偶然值青童	ou'ran'zhi'qing'tong	0
偶然中断	ou'ran'zhong'duan	0
偶然终日风	ou'ran'zhong'ri'feng	0
偶然著道书	ou'ran'zhu'dao'shu	0
偶然状况偶然状况	ou'ran'zhuang'kuang'ou'ran'zhuang'kuang	0
偶然追还期	ou'ran'zhui'huan'qi	0
偶然擢秀非难取	ou'ran'zhuo'xiu'fei'nan'qu	0
偶然组合	ou'ran'zu'he	0
偶然樽酒相劳苦	ou'ran'zun'jiu'xiang'lao'ku	0
偶然樽俎对青灯	ou'ran'zun'zu'dui'qing'deng	0
偶然作用	ou'ran'zuo'yong	0
偶然作用偶然作用	ou'ran'zuo'yong'ou'ran'zuo'yong	0
欧让	ou'rang	0
呕热	ou're	0
欧热	ou're	0
偶人	ou'ren	0
怄人	ou'ren	0
欧人	ou'ren	0
欧仁	ou'ren	0
敺人必如己	ou'ren'bi'ru'ji	0
欧人地板	ou'ren'di'ban	0
偶人经雨踣	ou'ren'jing'yu'bo	0
偶人吗	ou'ren'ma	0
欧壬卓	ou'ren'zhuo	0
欧日	ou'ri	0
欧日大	ou'ri'da	0
欧日韩主流服饰	ou'ri'han'zhu'liu'fu'shi	0
欧日落叶松叶蜂	ou'ri'luo'ye'song'ye'feng	0
欧日照明	ou'ri'zhao'ming	0
偶容	ou'rong	0
欧荣	ou'rong	0
欧绒鸭绒	ou'rong'ya'rong	0
偶肉	ou'rou	0
欧茹恩	ou'ru'en	0
欧茹恩的恩赐	ou'ru'en'de'en'ci	0
偶入横山寺	ou'ru'heng'shan'si	0
偶入西斋院示释子恒璨	ou'ru'xi'zhai'yuan'shi'shi'zi'heng'can	0
欧瑞	ou'rui	0
欧锐	ou'rui	0
欧瑞城	ou'rui'cheng	0
欧瑞城镇	ou'rui'cheng'zhen	0
欧瑞传动电气	ou'rui'chuan'dong'dian'qi	0
欧瑞村庄指定传送卷轴	ou'rui'cun'zhuang'zhi'ding'chuan'song'juan'zhou	0
欧瑞大厦	ou'rui'da'sha	0
欧瑞尔贺西瑟	ou'rui'er'he'xi'se	0
欧瑞公司	ou'rui'gong'si	0
欧瑞浩	ou'rui'hao	0
欧瑞豪庭	ou'rui'hao'ting	0
欧瑞家具	ou'rui'jia'ju	0
欧瑞康	ou'rui'kang	0
欧瑞克	ou'rui'ke	0
欧瑞克百人队长	ou'rui'ke'bai'ren'dui'zhang	0
欧瑞克的水晶球	ou'rui'ke'de'shui'jing'qiu	0
欧瑞梨的怒火	ou'rui'li'de'nu'huo	0
欧瑞莲	ou'rui'lian	0
欧瑞领地	ou'rui'ling'di	0
欧瑞纳克	ou'rui'na'ke	0
区瑞强	ou'rui'qiang	0
欧瑞守护者	ou'rui'shou'hu'zhe	0
欧瑞斯特	ou'rui'si'te	0
欧瑞特	ou'rui'te	0
欧瑞头箍	ou'rui'tou'gu	0
欧瑞伟	ou'rui'wei	0
欧瑞香属	ou'rui'xiang'shu	0
欧瑞夜光鱼饵	ou'rui'ye'guang'yu'er	0
欧瑞苑	ou'rui'yuan	0
欧瑞支部长	ou'rui'zhi'bu'chang	0
欧瑞支部长	ou'rui'zhi'bu'zhang	0
欧润	ou'run	0
欧润办公	ou'run'ban'gong	0
欧润特	ou'run'te	0
欧若	ou'ruo	0
欧若拉	ou'ruo'la	0
欧若拉公主	ou'ruo'la'gong'zhu	0
欧萨	ou'sa	0
欧萨家园	ou'sa'jia'yuan	0
欧萨克	ou'sa'ke	0
欧萨咨询	ou'sa'zi'xun	0
欧赛彩印基地	ou'sai'cai'yin'ji'di	0
欧赛迪	ou'sai'di	0
欧塞尔	ou'sai'er	0
歐塞爾	ou'sai'er	0
欧赛华	ou'sai'hua	0
欧塞斯教派束环	ou'sai'si'jiao'pai'shu'huan	0
欧赛特	ou'sai'te	0
欧塞瓦	ou'sai'wa	0
欧三导电环	ou'san'dao'dian'huan	0
欧三洪	ou'san'hong	0
欧桑	ou'sang	0
欧色图片	ou'se'tu'pian	0
欧森	ou'sen	0
欧森国际	ou'sen'guo'ji	0
欧森咖	ou'sen'ka	0
欧森咖啡	ou'sen'ka'fei	0
欧森纳	ou'sen'na	0
欧森箱包	ou'sen'xiang'bao	0
欧莎	ou'sha	0
欧莎奥新天	ou'sha'ao'xin'tian	0
鸥沙草长连江暗	ou'sha'cao'zhang'lian'jiang'an	0
殴杀的流云	ou'sha'de'liu'yun	0
偶晒	ou'shai	0
欧山	ou'shan	0
瓯山	ou'shan	0
藕山	ou'shan	0
欧山村	ou'shan'cun	0
欧山小区	ou'shan'xiao'qu	0
欧山小学	ou'shan'xiao'xue	0
呕山泄谷争奔驰	ou'shan'xie'gu'zheng'ben'chi	0
欧山杨瘿蚊	ou'shan'yang'ying'wen	0
欧杉叶蜂姬小蜂	ou'shan'ye'feng'ji'xiao'feng	0
偶上	ou'shang	0
欧上	ou'shang	0
欧尚	ou'shang	0
藕上	ou'shang	0
鸥上	ou'shang	0
欧尚布艺	ou'shang'bu'yi	0
欧尚常熟店	ou'shang'chang'shu'dian	0
欧尚超市	ou'shang'chao'shi	0
欧尚超市北	ou'shang'chao'shi'bei	0
欧尚超市东	ou'shang'chao'shi'dong	0
欧尚超市五星店	ou'shang'chao'shi'wu'xing'dian	0
欧尚超市西	ou'shang'chao'shi'xi	0
欧尚大关店	ou'shang'da'guan'dian	0
欧尚大卖场	ou'shang'da'mai'chang	0
欧尚的	ou'shang'de	0
欧尚风情	ou'shang'feng'qing	0
欧尚服饰	ou'shang'fu'shi	0
欧尚服装	ou'shang'fu'zhuang	0
欧尚港闸店	ou'shang'gang'zha'dian	0
偶上高台成远眺	ou'shang'gao'tai'cheng'yuan'tiao	0
欧尚花园	ou'shang'hua'yuan	0
欧尚黄河店	ou'shang'huang'he'dian	0
欧尚婚纱摄影	ou'shang'hun'sha'she'ying	0
欧尚嘉定店	ou'shang'jia'ding'dian	0
欧尚科丰店	ou'shang'ke'feng'dian	0
欧尚啦	ou'shang'la	0
欧尚兰陵店	ou'shang'lan'ling'dian	0
欧尚了	ou'shang'le	0
欧尚名城	ou'shang'ming'cheng	0
欧尚摄影	ou'shang'she'ying	0
偶上天峰麓	ou'shang'tian'feng'lu	0
欧尚停车场	ou'shang'ting'che'chang	0
欧尚庭院	ou'shang'ting'yuan	0
欧尚五星店	ou'shang'wu'xing'dian	0
欧尚阳光谷	ou'shang'yang'guang'gu	0
欧尚宜家	ou'shang'yi'jia	0
欧尚一品	ou'shang'yi'pin	0
欧尚永宁店	ou'shang'yong'ning'dian	0
欧尚中原店	ou'shang'zhong'yuan'dian	0
讴韶	ou'shao	0
欧少赫	ou'shao'he	0
藕梢菱蔓不容网	ou'shao'ling'man'bu'rong'wang	0
鸥少没苍烟	ou'shao'mei'cang'yan	0
欧社	ou'she	0
欧舍尔	ou'she'er	0
区神父街	ou'shen'fu'jie	0
欧审国际	ou'shen'guo'ji	0
欧神莱	ou'shen'lai	0
欧神莱陶瓷有限公司	ou'shen'lai'tao'ci'you'xian'gong'si	0
偶什么时候	ou'shen'me'shi'hou	0
欧申纳斯	ou'shen'na'si	0
欧神诺	ou'shen'nuo	0
欧神诺瓷砖	ou'shen'nuo'ci'zhuan	0
欧神诺陶瓷	ou'shen'nuo'tao'ci	0
呕甚则长虫出	ou'shen'ze'chang'chong'chu	0
欧圣	ou'sheng	0
欧生	ou'sheng	0
欧盛	ou'sheng	0
欧圣宝	ou'sheng'bao	0
偶生成	ou'sheng'cheng	0
欧圣地板	ou'sheng'di'ban	0
偶圣睹昌期	ou'sheng'du'chang'qi	0
偶胜聊换节	ou'sheng'liao'huan'jie	0
偶生脉	ou'sheng'mai	0
偶生收益	ou'sheng'shou'yi	0
偶生叶	ou'sheng'ye	0
偶十	ou'shi	0
偶拾	ou'shi	0
欧仕	ou'shi	0
欧市	ou'shi	0
欧师	ou'shi	0
欧式	ou'shi	0
欧氏	ou'shi	0
欧石	ou'shi	0
欧蓍	ou'shi	0
欧诗	ou'shi	0
欧食	ou'shi	0
欧蓍白粉病	ou'shi'bai'fen'bing	0
欧氏变换	ou'shi'bian'huan	0
欧氏变换群	ou'shi'bian'huan'qun	0
欧氏扁鳉	ou'shi'bian'jiang	0
欧氏不变量	ou'shi'bu'bian'liang	0
欧式餐桌	ou'shi'can'zhuo	0
欧蓍草	ou'shi'cao	0
欧式抽屉	ou'shi'chou'ti	0
欧氏除法	ou'shi'chu'fa	0
欧式床	ou'shi'chuang	0
欧式脆	ou'shi'cui	0
欧式脆皮	ou'shi'cui'pi	0
欧式脆皮蛋糕	ou'shi'cui'pi'dan'gao	0
欧氏大陶乐鲶	ou'shi'da'tao'le'nian	0
欧式贷钩	ou'shi'dai'gou	0
欧式蛋糕	ou'shi'dan'gao	0
欧饰蒂男装	ou'shi'di'nan'zhuang	0
偶适地性生物	ou'shi'di'xing'sheng'wu	0
欧食多	ou'shi'duo	0
欧仕丰	ou'shi'feng	0
欧式风	ou'shi'feng	0
欧诗格诺	ou'shi'ge'nuo	0
欧式构件厂	ou'shi'gou'jian'chang	0
欧式果盘	ou'shi'guo'pan	0
欧氏海蜥鱼	ou'shi'hai'xi'yu	0
偶拾鹤毳遗	ou'shi'he'cui'yi	0
欧石鸻	ou'shi'heng	0
欧氏后哲水蚤	ou'shi'hou'zhe'shui'zao	0
欧式花园	ou'shi'hua'yuan	0
欧氏几何	ou'shi'ji'he	0
欧饰家	ou'shi'jia	0
欧式建材	ou'shi'jian'cai	0
欧氏尖吻鲨	ou'shi'jian'wen'sha	0
欧式建筑	ou'shi'jian'zhu	0
欧式街	ou'shi'jie	0
欧氏经典	ou'shi'jing'dian	0
欧式精纺纯棉四件套	ou'shi'jing'fang'chun'mian'si'jian'tao	0
欧氏荆鲨	ou'shi'jing'sha	0
欧氏距离	ou'shi'ju'li	0
欧氏菌	ou'shi'jun	0
欧式咖	ou'shi'ka	0
欧式咖啡	ou'shi'ka'fei	0
欧适可	ou'shi'ke	0
欧氏空间	ou'shi'kong'jian	0
欧石斓	ou'shi'lan	0
欧石斓酒	ou'shi'lan'jiu	0
欧石斓酒吧	ou'shi'lan'jiu'ba	0
欧时力	ou'shi'li	0
欧时力官方旗舰男装	ou'shi'li'guan'fang'qi'jian'nan'zhuang	0
欧式礼帽	ou'shi'li'mao	0
欧式礼帽粉	ou'shi'li'mao'fen	0
欧式礼帽红	ou'shi'li'mao'hong	0
欧式礼帽蓝	ou'shi'li'mao'lan	0
欧时力男装官方旗舰	ou'shi'li'nan'zhuang'guan'fang'qi'jian	0
欧时力专卖店	ou'shi'li'zhuan'mai'dian	0
欧式连接双环扣	ou'shi'lian'jie'shuang'huan'kou	0
欧诗琳	ou'shi'lin	0
欧狮龙	ou'shi'long	0
偶失龙头望	ou'shi'long'tou'wang	0
欧仕罗萨旗舰店	ou'shi'luo'sa'qi'jian'dian	0
欧诗麦	ou'shi'mai	0
欧诗漫	ou'shi'man	0
欧诗漫化妆品商行	ou'shi'man'hua'zhuang'pin'shang'hang	0
欧诗漫街	ou'shi'man'jie	0
欧氏美冠鳚	ou'shi'mei'guan'wei	0
欧式名驰	ou'shi'ming'chi	0
欧式木框掩门	ou'shi'mu'kuang'yan'men	0
欧石楠	ou'shi'nan	0
欧氏平头鱼	ou'shi'ping'tou'yu	0
欧氏平鲉	ou'shi'ping'you	0
欧式期权	ou'shi'qi'quan	0
欧式权证	ou'shi'quan'zheng	0
欧式沙发	ou'shi'sha'fa	0
欧式商城	ou'shi'shang'cheng	0
欧氏狮子鱼	ou'shi'shi'zi'yu	0
偶是水桶	ou'shi'shui'tong	0
偶示所怀	ou'shi'suo'huai	0
欧氏体	ou'shi'ti	0
欧式铁艺	ou'shi'tie'yi	0
欧式托盘	ou'shi'tuo'pan	0
欧式西服	ou'shi'xi'fu	0
欧式洗浴休闲	ou'shi'xi'yu'xiu'xian	0
欧式箱变	ou'shi'xiang'bian	0
欧氏偕老同穴	ou'shi'xie'lao'tong'xue	0
欧式写纸上	ou'shi'xie'zhi'shang	0
欧式行权	ou'shi'xing'quan	0
欧式休闲女靴	ou'shi'xiu'xian'nv'xue	0
欧式选择权	ou'shi'xuan'ze'quan	0
欧式眼	ou'shi'yan	0
欧式烟机	ou'shi'yan'ji	0
欧式羊角抓钩	ou'shi'yang'jiao'zhua'gou	0
欧氏鳐	ou'shi'yao	0
偶舐药鼎馀	ou'shi'yao'ding'yu	0
欧式椅	ou'shi'yi	0
欧式一框艺雕	ou'shi'yi'kuang'yi'diao	0
欧氏易熔合金	ou'shi'yi'rong'he'jin	0
欧氏银鲛	ou'shi'yin'jiao	0
欧式优雅西裤	ou'shi'you'ya'xi'ku	0
欧氏芋螺	ou'shi'yu'luo	0
欧市早盘	ou'shi'zao'pan	0
偶十则	ou'shi'ze	0
欧氏整环	ou'shi'zheng'huan	0
欧式重乳酪蛋糕	ou'shi'zhong'ru'lao'dan'gao	0
欧氏锥齿鲨	ou'shi'zhui'chi'sha	0
欧守诚	ou'shou'cheng	0
偶手机号	ou'shou'ji'hao	0
偶数	ou'shu	0
欧树	ou'shu	0
偶数层	ou'shu'ceng	0
偶数场	ou'shu'chang	0
偶数弹	ou'shu'dan	0
欧舒丹	ou'shu'dan	0
偶数道次	ou'shu'dao'ci	0
偶数的	ou'shu'de	0
偶数对	ou'shu'dui	0
偶数规则	ou'shu'gui'ze	0
偶数继电器	ou'shu'ji'dian'qi	0
偶数奇偶校验	ou'shu'ji'ou'jiao'yan	0
偶数奇数的	ou'shu'ji'shu'de	0
欧鼠李	ou'shu'li	0
欧鼠李叶碱	ou'shu'li'ye'jian	0
偶数扫描	ou'shu'sao'miao	0
偶数噬菌体	ou'shu'shi'jun'ti	0
欧舒特	ou'shu'te	0
偶数同位	ou'shu'tong'wei	0
殴殳沃利	ou'shu'wo'li	0
偶数性	ou'shu'xing	0
欧叔子	ou'shu'zi	0
鸥双鹭只傍汀沙	ou'shuang'lu'zhi'bang'ting'sha	0
欧水	ou'shui	0
鸥水相依	ou'shui'xiang'yi	0
偶说滴	ou'shuo'di	0
偶似	ou'si	0
呕死	ou'si	0
欧思	ou'si	0
欧斯	ou'si	0
藕丝	ou'si	0
欧斯本	ou'si'ben	0
欧斯本大团长	ou'si'ben'da'tuan'zhang	0
藕丝步云履	ou'si'bu'yun'lv	0
藕丝羹	ou'si'geng	0
藕丝挂在虚空中	ou'si'gua'zai'xu'kong'zhong	0
欧斯吉利亚斯	ou'si'ji'li'ya'si	0
欧司朗	ou'si'lang	0
欧司朗照明	ou'si'lang'zhao'ming	0
呕死了	ou'si'le	0
欧丝丽	ou'si'li	0
欧斯里克	ou'si'li'ke	0
欧斯啉	ou'si'lin	0
藕丝菱叶傍江时	ou'si'ling'ye'bang'jiang'shi	0
欧斯龙	ou'si'long	0
欧斯龙金属吊顶	ou'si'long'jin'shu'diao'ding	0
欧斯罗德	ou'si'luo'de	0
欧斯麦蛋卷礼盒	ou'si'mai'dan'juan'li'he	0
欧思漫	ou'si'man	0
欧斯曼	ou'si'man	0
欧思漫咖	ou'si'man'ka	0
欧思漫咖啡	ou'si'man'ka'fei	0
欧思美	ou'si'mei	0
欧斯蒙	ou'si'meng	0
藕丝难杀	ou'si'nan'sha	0
呕死你啊	ou'si'ni'a	0
偶思暖老庖玄鲫	ou'si'nuan'lao'pao'xuan'ji	0
藕丝衫	ou'si'shan	0
偶似山林客	ou'si'shan'lin'ke	0
藕丝衫子柳花裙	ou'si'shan'zi'liu'hua'qun	0
偶似蜀江清	ou'si'shu'jiang'qing	0
欧斯特	ou'si'te	0
欧斯特皮革工业品武汉有限公司	ou'si'te'pi'ge'gong'ye'pin'wu'han'you'xian'gong'si	0
欧斯特因埃第尔	ou'si'te'yin'ai'di'er	0
欧斯托赫尔	ou'si'tuo'he'er	0
欧斯纹章制造人	ou'si'wen'zhang'zhi'zao'ren	0
偶似西山夫	ou'si'xi'shan'fu	0
欧四小区	ou'si'xiao'qu	0
藕丝靴	ou'si'xue	0
欧斯雅尼	ou'si'ya'ni	0
欧斯亚史烈斯猫	ou'si'ya'shi'lie'si'mao	0
欧思妍	ou'si'yan	0
藕丝萦断归艇	ou'si'ying'duan'gui'ting	0
欧斯蛛属	ou'si'zhu'shu	0
藕丝蛛网三丈余	ou'si'zhu'wang'san'zhang'yu	0
藕丝蛛网三丈馀	ou'si'zhu'wang'san'zhang'yu	0
藕丝作线难胜针	ou'si'zuo'xian'nan'sheng'zhen	0
欧松	ou'song	0
欧松板	ou'song'ban	0
欧松钝喙大蚜	ou'song'dun'hui'da'ya	0
欧颂酒庄	ou'song'jiu'zhuang	0
欧松卷蛾啮小蜂	ou'song'juan'e'nie'xiao'feng	0
欧素	ou'su	0
欧苏	ou'su	0
瓯塑	ou'su	0
欧苏丹	ou'su'dan	0
偶俗机偏少	ou'su'ji'pian'shao	0
偶宿俱南客	ou'su'ju'nan'ke	0
偶宿泣珠人	ou'su'qi'zhu'ren	0
欧苏无恙时	ou'su'wu'yang'shi	0
呕宿汁	ou'su'zhi	0
欧苏注射液	ou'su'zhu'she'ye	0
呕酸	ou'suan	0
偶随白云出	ou'sui'bai'yun'chu	0
偶随樗栎生	ou'sui'chu'li'sheng	0
偶随儿戏洒墨汁	ou'sui'er'xi'sa'mo'zhi	0
偶随孤犊去	ou'sui'gu'du'qu	0
偶随花草去	ou'sui'hua'cao'qu	0
偶遂龙居诺	ou'sui'long'ju'nuo	0
偶随鹏翼培风上	ou'sui'peng'yi'pei'feng'shang	0
偶随樵父采都梁	ou'sui'qiao'fu'cai'du'liang	0
偶随香署客	ou'sui'xiang'shu'ke	0
欧索	ou'suo	0
欧索多	ou'suo'duo	0
欧索米	ou'suo'mi	0
欧索米萝	ou'suo'mi'luo	0
欧索米萝咖啡	ou'suo'mi'luo'ka'fei	0
欧塔	ou'ta	0
欧塔妃	ou'ta'fei	0
欧塔克其村委会	ou'ta'ke'qi'cun'wei'hui	0
欧塔蓝天使	ou'ta'lan'tian'shi	0
欧塔利亚	ou'ta'li'ya	0
欧塔迈伦	ou'ta'mai'lun	0
欧塔奴老三	ou'ta'nu'lao'san	0
欧塔诺米	ou'ta'nuo'mi	0
欧塔托	ou'ta'tuo	0
偶太	ou'tai	0
欧台	ou'tai	0
欧泰	ou'tai	0
藕泰	ou'tai	0
藕泰餐	ou'tai'can	0
藕泰餐吧	ou'tai'can'ba	0
欧泰机电设备	ou'tai'ji'dian'she'bei	0
欧泰咖啡	ou'tai'ka'fei	0
欧泰克	ou'tai'ke	0
欧泰科	ou'tai'ke	0
欧泰特	ou'tai'te	0
欧泰特钥匙	ou'tai'te'yao'shi	0
欧坦	ou'tan	0
欧潭	ou'tan	0
藕炭	ou'tan	0
欧坦村	ou'tan'cun	0
偶谈玄言直	ou'tan'xuan'yan'zhi	0
欧堂	ou'tang	0
欧塘	ou'tang	0
藕塘	ou'tang	0
藕汤	ou'tang	0
藕塘坳	ou'tang'ao	0
藕塘边	ou'tang'bian	0
藕塘冲	ou'tang'chong	0
欧塘村	ou'tang'cun	0
藕塘村	ou'tang'cun	0
欧堂村委会	ou'tang'cun'wei'hui	0
藕塘的	ou'tang'de	0
藕塘基	ou'tang'ji	0
藕塘滘	ou'tang'jiao	0
藕塘角	ou'tang'jiao	0
藕塘口	ou'tang'kou	0
藕塘里	ou'tang'li	0
藕塘路	ou'tang'lu	0
藕塘南北棹	ou'tang'nan'bei'zhao	0
欧唐宁	ou'tang'ning	0
藕塘坡	ou'tang'po	0
藕塘坡社区	ou'tang'po'she'qu	0
藕塘桥	ou'tang'qiao	0
藕塘水库	ou'tang'shui'ku	0
藕塘头	ou'tang'tou	0
藕塘湾	ou'tang'wan	0
藕塘湾村	ou'tang'wan'cun	0
藕塘乡	ou'tang'xiang	0
藕塘小区	ou'tang'xiao'qu	0
藕塘小学	ou'tang'xiao'xue	0
藕塘镇	ou'tang'zhen	0
藕塘职教园	ou'tang'zhi'jiao'yuan	0
藕塘中学	ou'tang'zhong'xue	0
藕塘庄	ou'tang'zhuang	0
藕塘子	ou'tang'zi	0
欧套	ou'tao	0
欧特	ou'te	0
欧特橱柜	ou'te'chu'gui	0
欧特尔珠宝	ou'te'er'zhu'bao	0
欧特福	ou'te'fu	0
欧特福超市	ou'te'fu'chao'shi	0
欧特花园	ou'te'hua'yuan	0
欧特佳	ou'te'jia	0
欧特朗照明	ou'te'lang'zhao'ming	0
欧特利	ou'te'li	0
欧特里夫	ou'te'li'fu	0
欧特里夫阶	ou'te'li'fu'jie	0
欧特琳	ou'te'lin	0
欧特琳宗师	ou'te'lin'zong'shi	0
欧特鲁斯	ou'te'lu'si	0
欧特罗康	ou'te'luo'kang	0
欧特美	ou'te'mei	0
欧特莫托	ou'te'mo'tuo	0
欧特能	ou'te'neng	0
欧特奴	ou'te'nu	0
歐特佩尼	ou'te'pei'ni	0
欧特色拉	ou'te'se'la	0
欧特尚	ou'te'shang	0
欧特照明	ou'te'zhao'ming	0
偶蹄	ou'ti	0
偶题	ou'ti	0
欧体	ou'ti	0
欧提	ou'ti	0
偶题八韵	ou'ti'ba'yun	0
偶蹄传送点	ou'ti'chuan'song'dian	0
偶题东壁	ou'ti'dong'bi	0
偶蹄动物	ou'ti'dong'wu	0
偶题二首	ou'ti'er'shou	0
偶题阁下厅	ou'ti'ge'xia'ting	0
偶题卷后	ou'ti'juan'hou	0
偶蹄类	ou'ti'lei	0
欧缇丽	ou'ti'li	0
偶题六韵	ou'ti'liu'yun	0
欧提路克	ou'ti'lu'ke	0
欧提路克冰封法球	ou'ti'lu'ke'bing'feng'fa'qiu	0
欧提路克灵动法球	ou'ti'lu'ke'ling'dong'fa'qiu	0
欧提路克魔封法球	ou'ti'lu'ke'mo'feng'fa'qiu	0
欧提玛	ou'ti'ma	0
偶蹄目	ou'ti'mu	0
偶题饶秀才溪光亭	ou'ti'rao'xiu'cai'xi'guang'ting	0
偶题三韵	ou'ti'san'yun	0
偶题诗句不须编	ou'ti'shi'ju'bu'xu'bian	0
偶题十六韵	ou'ti'shi'liu'yun	0
偶题石上时为河南尹	ou'ti'shi'shang'shi'wei'he'nan'yin	0
欧缇缇	ou'ti'ti	0
偶蹄通道	ou'ti'tong'dao	0
欧提托	ou'ti'tuo	0
偶题文章千古事	ou'ti'wen'zhang'qian'gu'shi	0
偶题五字句	ou'ti'wu'zi'ju	0
偶题西亭	ou'ti'xi'ting	0
偶题小楼	ou'ti'xiao'lou	0
欧提亚	ou'ti'ya	0
欧替药业	ou'ti'yao'ye	0
欧田	ou'tian	0
藕田	ou'tian	0
偶跳了	ou'tiao'le	0
欧亭	ou'ting	0
欧庭	ou'ting	0
欧挺	ou'ting	0
欧汀	ou'ting	0
鸥汀	ou'ting	0
偶听黄鹂第一声	ou'ting'huang'li'di'yi'sheng	0
欧庭荠	ou'ting'ji	0
鸥汀街道	ou'ting'jie'dao	0
偶听梅梢啼一鸟	ou'ting'mei'shao'ti'yi'niao	0
偶听松梢扑鹿	ou'ting'song'shao'pu'lu	0
偶听一作闻得黄鹂第一声	ou'ting'yi'zuo'wen'de'huang'li'di'yi'sheng	0
欧通	ou'tong	0
偶同海鸟梦	ou'tong'hai'niao'meng	0
欧通集团	ou'tong'ji'tuan	0
偶同佳客见	ou'tong'jia'ke'jian	0
偶同闻喜听钧天	ou'tong'wen'xi'ting'jun'tian	0
偶同一饭论三益	ou'tong'yi'fan'lun'san'yi	0
藕头	ou'tou	0
毆头逼	ou'tou'bi	0
偶头痛嗅觉异常	ou'tou'tong'xiu'jue'yi'chang	0
偶图	ou'tu	0
呕吐	ou'tu	0
嘔吐	ou'tu	0
欧图蝙蝠	ou'tu'bian'fu	0
呕吐病	ou'tu'bing	0
呕吐不渴	ou'tu'bu'ke	0
呕吐袋	ou'tu'dai	0
呕吐恶心	ou'tu'e'xin	0
呕吐而病在膈上	ou'tu'er'bing'zai'ge'shang	0
呕吐而利	ou'tu'er'li	0
呕吐而下利者	ou'tu'er'xia'li'zhe	0
呕吐黄绿苦水	ou'tu'huang'lv'ku'shui	0
呕吐哕下利病脉证治第十七	ou'tu'hui'xia'li'bing'mai'zheng'zhi'di'shi'qi	0
呕吐霍乱	ou'tu'huo'luan	0
呕吐加姜少气草	ou'tu'jia'jiang'shao'qi'cao	0
呕吐苦水	ou'tu'ku'shui	0
欧吐拉	ou'tu'la	0
欧吐拉喀恰村委会	ou'tu'la'ka'qia'cun'wei'hui	0
欧吐拉库木巴村委会	ou'tu'la'ku'mu'ba'cun'wei'hui	0
欧吐拉帕万村委会	ou'tu'la'pa'wan'cun'wei'hui	0
欧吐拉苏盖特艾日克村委会	ou'tu'la'su'gai'te'ai'ri'ke'cun'wei'hui	0
欧吐拉提埂村委会	ou'tu'la'ti'geng'cun'wei'hui	0
欧吐拉吐古其村委会	ou'tu'la'tu'gu'qi'cun'wei'hui	0
欧吐拉吾斯塘村委会	ou'tu'la'wu'si'tang'cun'wei'hui	0
欧吐拉硝尔艾日克村委会	ou'tu'la'xiao'er'ai'ri'ke'cun'wei'hui	0
欧吐拉亚巴格村委会	ou'tu'la'ya'ba'ge'cun'wei'hui	0
呕吐流	ou'tu'liu	0
呕吐你	ou'tu'ni	0
欧图尼	ou'tu'ni	0
欧途欧	ou'tu'ou	0
呕吐呕逆	ou'tu'ou'ni	0
呕吐片	ou'tu'pian	0
呕吐清水	ou'tu'qing'shui	0
偶突然	ou'tu'ran	0
呕吐肉片	ou'tu'rou'pian	0
呕吐生欢喜	ou'tu'sheng'huan'xi	0
呕吐酸苦黄水	ou'tu'suan'ku'huang'shui	0
呕吐酸水	ou'tu'suan'shui	0
呕吐痰涎	ou'tu'tan'xian	0
呕吐吞酸	ou'tu'tun'suan	0
呕吐沃沫	ou'tu'wo'mo	0
呕吐涎唾	ou'tu'xian'tuo	0
呕吐鲜血	ou'tu'xian'xue	0
呕吐泄泻	ou'tu'xie'xie	0
呕吐中枢	ou'tu'zhong'shu	0
欧团	ou'tuan	0
藕团	ou'tuan	0
藕团乡	ou'tuan'xiang	0
偶屯	ou'tun	0
欧屯	ou'tun	0
欧吞苏村委会	ou'tun'su'cun'wei'hui	0
欧托	ou'tuo	0
欧拓斯	ou'tuo'si	0
偶托文字工	ou'tuo'wen'zi'gong	0
欧托乌	ou'tuo'wu	0
欧瓦海岸	ou'wa'hai'an	0
欧瓦幽谷	ou'wa'you'gu	0
欧瓦幽谷传送点	ou'wa'you'gu'chuan'song'dian	0
瓯外	ou'wai	0
呕完	ou'wan	0
欧湾	ou'wan	0
藕丸	ou'wan	0
欧湾村	ou'wan'cun	0
欧纨青	ou'wan'qing	0
欧万容组	ou'wan'rong'zu	0
欧万燕组	ou'wan'yan'zu	0
偶往即通津	ou'wang'ji'tong'jin	0
欧王葡萄酒	ou'wang'pu'tao'jiu	0
欧为	ou'wei	0
欧位	ou'wei	0
欧威	ou'wei	0
欧维	ou'wei	0
欧薇	ou'wei	0
藕围	ou'wei	0
偶为达者知	ou'wei'da'zhe'zhi	0
偶为高风振羽仪	ou'wei'gao'feng'zhen'yu'yi	0
欧微洛斯	ou'wei'luo'si	0
偶为名利引	ou'wei'ming'li'yin	0
欧维欧服装有限公司	ou'wei'ou'fu'zhuang'you'xian'gong'si	0
偶未三见黜	ou'wei'san'jian'chu	0
偶为世务牵	ou'wei'shi'wu'qian	0
欧维思	ou'wei'si	0
欧维丝绸	ou'wei'si'chou	0
欧维苔妮	ou'wei'tai'ni	0
欧唯特	ou'wei'te	0
欧维婷	ou'wei'ting	0
偶为谢客事	ou'wei'xie'ke'shi	0
偶为寻僧出竹扉	ou'wei'xun'seng'chu'zhu'fei	0
偶未知耳	ou'wei'zhi'er	0
偶温	ou'wen	0
偶闻	ou'wen	0
欧吻	ou'wen	0
欧文	ou'wen	0
瓯文	ou'wen	0
欧文办公	ou'wen'ban'gong	0
欧文避难所	ou'wen'bi'nan'suo	0
欧文避难所传送点	ou'wen'bi'nan'suo'chuan'song'dian	0
欧文岛	ou'wen'dao	0
欧文岛传送点	ou'wen'dao'chuan'song'dian	0
欧文的许愿井	ou'wen'de'xu'yuan'jing	0
欧文佛书之二	ou'wen'fo'shu'zhi'er	0
欧文佛书之三	ou'wen'fo'shu'zhi'san	0
欧文佛书之一	ou'wen'fo'shu'zhi'yi	0
偶闻花发喜相邀	ou'wen'hua'fa'xi'xiang'yao	0
偶闻佳句独含情	ou'wen'jia'ju'du'han'qing	0
欧文鳉	ou'wen'jiang	0
欧文考德韦尔	ou'wen'kao'de'wei'er	0
偶问客年惊我老	ou'wen'ke'nian'jing'wo'lao	0
欧文拉斯	ou'wen'la'si	0
欧文莱	ou'wen'lai	0
欧文莱陶瓷	ou'wen'lai'tao'ci	0
欧文隆头丽鱼	ou'wen'long'tou'li'yu	0
欧文魮	ou'wen'pi	0
欧文球衣凯尔特人	ou'wen'qiu'yi'kai'er'te'ren	0
欧文氏杆菌	ou'wen'shi'gan'jun	0
欧文氏线	ou'wen'shi'xian	0
欧文氏准小鲈	ou'wen'shi'zhun'xiao'lu	0
欧文斯	ou'wen'si	0
欧文斯奖	ou'wen'si'jiang	0
欧文斯科宁	ou'wen'si'ke'ning	0
偶闻太宰	ou'wen'tai'zai	0
欧文托普	ou'wen'tuo'pu	0
欧文外国语学校	ou'wen'wai'guo'yu'xue'xiao	0
欧文卫衣男连帽	ou'wen'wei'yi'nan'lian'mao	0
欧文卫衣男连帽德鲁大叔套头	ou'wen'wei'yi'nan'lian'mao'de'lu'da'shu'tao'tou	0
欧文线	ou'wen'xian	0
欧文选集	ou'wen'xuan'ji	0
欧文训练背心	ou'wen'xun'lian'bei'xin	0
欧文英	ou'wen'ying	0
偶闻真僧言	ou'wen'zhen'seng'yan	0
欧我	ou'wo	0
偶我吗	ou'wo'ma	0
欧沃萨蒙	ou'wo'sa'meng	0
欧沃斯巴克	ou'wo'si'ba'ke	0
欧沃斯巴克的保密协议	ou'wo'si'ba'ke'de'bao'mi'xie'yi	0
欧乌	ou'wu	0
欧屋	ou'wu	0
欧武	ou'wu	0
欧屋村	ou'wu'cun	0
欧乌鸫	ou'wu'dong	0
偶无斧斤寻	ou'wu'fu'jin'xun	0
偶无公事负朝暄	ou'wu'gong'shi'fu'chao'xuan	0
偶无公事客休时	ou'wu'gong'shi'ke'xiu'shi	0
偶无奈	ou'wu'nai	0
欧呜欧	ou'wu'ou	0
欧五小区	ou'wu'xiao'qu	0
欧无邪	ou'wu'xie	0
欧溪	ou'xi	0
欧西	ou'xi	0
欧溪村	ou'xi'cun	0
欧西德	ou'xi'de	0
欧希恩	ou'xi'en	0
欧西尔七河	ou'xi'er'qi'he	0
偶稀饭这个	ou'xi'fan'zhe'ge	0
欧西里斯	ou'xi'li'si	0
歐西里斯	ou'xi'li'si	0
欧西里斯神	ou'xi'li'si'shen	0
欧西玛	ou'xi'ma	0
欧西猫	ou'xi'mao	0
欧喜门	ou'xi'men	0
偶系母老虎	ou'xi'mu'lao'hu	0
欧西瑞安德	ou'xi'rui'an'de	0
欧西斯阔矛	ou'xi'si'kuo'mao	0
欧西斯阔矛的刀身	ou'xi'si'kuo'mao'de'dao'shen	0
欧西斯头盔	ou'xi'si'tou'kui	0
欧西斯战斧	ou'xi'si'zhan'fu	0
欧西斯战斧的刀身	ou'xi'si'zhan'fu'de'dao'shen	0
欧西斯战戟	ou'xi'si'zhan'ji	0
欧西斯战戟的戟身	ou'xi'si'zhan'ji'de'ji'shen	0
欧西斯之剑	ou'xi'si'zhi'jian	0
欧西喜	ou'xi'xi	0
欧西西	ou'xi'xi	0
欧西亚	ou'xi'ya	0
欧喜元	ou'xi'yuan	0
欧希约	ou'xi'yue	0
偶下	ou'xia	0
欧下	ou'xia	0
藕下	ou'xia	0
鸥下	ou'xia	0
欧夏刚水晶粉末	ou'xia'gang'shui'jing'fen'mo	0
鸥下里	ou'xia'li	0
欧夏至草属	ou'xia'zhi'cao'shu	0
偶线	ou'xian	0
欧先	ou'xian	0
欧线	ou'xian	0
偶蚬蝶属	ou'xian'die'shu	0
欧显国	ou'xian'guo	0
偶先红杏占年芳	ou'xian'hong'xing'zhan'nian'fang	0
偶线期	ou'xian'qi	0
欧先生	ou'xian'sheng	0
偶献子虚登上第	ou'xian'zi'xu'deng'shang'di	0
偶像	ou'xiang	0
偶项	ou'xiang	0
欧乡	ou'xiang	0
欧翔	ou'xiang	0
欧香	ou'xiang	0
瓯乡	ou'xiang	0
藕巷	ou'xiang	0
藕香	ou'xiang	0
鸥翔奥锋	ou'xiang'ao'feng	0
偶像包袱	ou'xiang'bao'fu	0
藕香泊	ou'xiang'bo	0
瓯香茶色嫩	ou'xiang'cha'se'nen	0
偶像长裤	ou'xiang'chang'ku	0
偶像超音速	ou'xiang'chao'yin'su	0
偶像大师	ou'xiang'da'shi	0
偶像的黎明	ou'xiang'de'li'ming	0
偶像的秘密	ou'xiang'de'mi'mi	0
偶象的训诲算甚么呢	ou'xiang'de'xun'hui'suan'shen'me'ne	0
偶向东湖更向东	ou'xiang'dong'hu'geng'xiang'dong	0
偶像恶魔	ou'xiang'e'mo	0
偶像发型	ou'xiang'fa'xing	0
欧香坊	ou'xiang'fang	0
偶相逢	ou'xiang'feng	0
偶像歌手	ou'xiang'ge'shou	0
偶相互酌	ou'xiang'hu'zhuo	0
偶像化	ou'xiang'hua	0
欧香花	ou'xiang'hua	0
欧香花园	ou'xiang'hua'yuan	0
欧香花园咖啡	ou'xiang'hua'yuan'ka'fei	0
偶像级	ou'xiang'ji	0
欧香家园	ou'xiang'jia'yuan	0
偶向江边采白蘋	ou'xiang'jiang'bian'cai'bai'pin	0
偶向江边采白苹	ou'xiang'jiang'bian'cai'bai'ping	0
偶像精品	ou'xiang'jing'pin	0
偶向经中寻	ou'xiang'jing'zhong'xun	0
欧翔玖玖滑雪场	ou'xiang'jiu'jiu'hua'xue'chang	0
偶像剧	ou'xiang'ju	0
藕香居	ou'xiang'ju	0
偶像军团	ou'xiang'jun'tuan	0
欧乡咖	ou'xiang'ka	0
欧乡咖啡	ou'xiang'ka'fei	0
偶像课程	ou'xiang'ke'cheng	0
偶向匡庐去	ou'xiang'kuang'lu'qu	0
偶像练系生	ou'xiang'lian'xi'sheng	0
偶像练习生同款	ou'xiang'lian'xi'sheng'tong'kuan	0
偶像练系生同款	ou'xiang'lian'xi'sheng'tong'kuan	0
偶像练系生同款练衣服蔡徐坤	ou'xiang'lian'xi'sheng'tong'kuan'lian'yi'fu'cai'xu'kun	0
偶像练习生同款卫衣	ou'xiang'lian'xi'sheng'tong'kuan'wei'yi	0
偶像练习生同款衣服	ou'xiang'lian'xi'sheng'tong'kuan'yi'fu	0
偶像练系生同款衣服	ou'xiang'lian'xi'sheng'tong'kuan'yi'fu	0
偶像练习生卫衣	ou'xiang'lian'xi'sheng'wei'yi	0
偶像练习生西装	ou'xiang'lian'xi'sheng'xi'zhuang	0
偶像练习生衣服	ou'xiang'lian'xi'sheng'yi'fu	0
偶像练系生衣服	ou'xiang'lian'xi'sheng'yi'fu	0
偶像练系生衣服蔡徐坤	ou'xiang'lian'xi'sheng'yi'fu'cai'xu'kun	0
偶像练系生衣服蔡徐坤同款	ou'xiang'lian'xi'sheng'yi'fu'cai'xu'kun'tong'kuan	0
偶像练系生衣服蔡徐坤同款红色	ou'xiang'lian'xi'sheng'yi'fu'cai'xu'kun'tong'kuan'hong'se	0
偶像练系生衣服蔡徐坤同款卫衣	ou'xiang'lian'xi'sheng'yi'fu'cai'xu'kun'tong'kuan'wei'yi	0
偶像猎手	ou'xiang'lie'shou	0
偶像们的秘密	ou'xiang'men'de'mi'mi	0
偶像们的秘密后篇	ou'xiang'men'de'mi'mi'hou'pian	0
偶像们的秘密前篇	ou'xiang'men'de'mi'mi'qian'pian	0
偶像们的误解	ou'xiang'men'de'wu'jie	0
偶像梦幻祭	ou'xiang'meng'huan'ji	0
偶像密室杀人事件	ou'xiang'mi'shi'sha'ren'shi'jian	0
欧香面包	ou'xiang'mian'bao	0
偶像面前磕头	ou'xiang'mian'qian'ke'tou	0
欧香名邸	ou'xiang'ming'di	0
欧香名苑	ou'xiang'ming'yuan	0
偶像皮鞋	ou'xiang'pi'xie	0
偶像破灭	ou'xiang'po'mie	0
藕香芹味	ou'xiang'qin'wei	0
瓯乡人	ou'xiang'ren	0
瓯乡人家	ou'xiang'ren'jia	0
偶像人马造形术	ou'xiang'ren'ma'zao'xing'shu	0
偶像上衣	ou'xiang'shang'yi	0
偶像手记	ou'xiang'shou'ji	0
偶像手套	ou'xiang'shou'tao	0
偶像手套华丽	ou'xiang'shou'tao'hua'li	0
偶像手套蓝	ou'xiang'shou'tao'lan	0
藕香墅	ou'xiang'shu	0
偶向宋家东	ou'xiang'song'jia'dong	0
偶向松间觅旧题	ou'xiang'song'jian'mi'jiu'ti	0
偶像天团养成记	ou'xiang'tian'tuan'yang'cheng'ji	0
偶像万岁	ou'xiang'wan'sui	0
偶像万万岁	ou'xiang'wan'wan'sui	0
偶像围	ou'xiang'wei	0
欧襄蔚	ou'xiang'wei	0
欧湘屋	ou'xiang'wu	0
偶像先生	ou'xiang'xian'sheng	0
偶像香港版	ou'xiang'xiang'gang'ban	0
偶像效应	ou'xiang'xiao'ying	0
藕香榭	ou'xiang'xie	0
藕香榭已经摆下了	ou'xiang'xie'yi'jing'bai'xia'le	0
藕巷新村	ou'xiang'xin'cun	0
偶向新丰市里过	ou'xiang'xin'feng'shi'li'guo	0
欧翔彦	ou'xiang'yan	0
偶像有约	ou'xiang'you'yue	0
藕香园	ou'xiang'yuan	0
偶像造物	ou'xiang'zao'wu	0
欧香中	ou'xiang'zhong	0
偶像专卖店	ou'xiang'zhuan'mai'dian	0
欧香庄	ou'xiang'zhuang	0
欧香庄园	ou'xiang'zhuang'yuan	0
偶晓得哩	ou'xiao'de'li	0
欧小花	ou'xiao'hua	0
欧小姐	ou'xiao'jie	0
藕绡纹缕裁来滑	ou'xiao'wen'lv'cai'lai'hua	0
欧校长	ou'xiao'zhang	0
呕泄	ou'xie	0
藕榭	ou'xie	0
偶携白发禅	ou'xie'bai'fa'chan	0
呕泄不暂停	ou'xie'bu'zan'ting	0
藕榭二位学究来	ou'xie'er'wei'xue'jiu'lai	0
偶携降帜立诗坛	ou'xie'jiang'zhi'li'shi'tan	0
偶携老妻去	ou'xie'lao'qi'qu	0
偶写所怀	ou'xie'suo'huai	0
呕泄卧数日	ou'xie'wo'shu'ri	0
偶携闲客此闲游	ou'xie'xian'ke'ci'xian'you	0
欧新	ou'xin	0
鸥心驰舍北	ou'xin'chi'she'bei	0
呕心抽肠	ou'xin'chou'chang	0
呕心滴血	ou'xin'di'xue	0
呕心沥血	ou'xin'li'xue	0
呕心镂骨	ou'xin'lou'gu	0
呕心吐胆	ou'xin'tu'dan	0
瓯新小区	ou'xin'xiao'qu	0
欧辛庄村	ou'xin'zhuang'cun	0
欧星	ou'xing	0
鸥行炯自如	ou'xing'jiong'zi'ru	0
偶星期五	ou'xing'qi'wu	0
偶形制作	ou'xing'zhi'zuo	0
偶熊	ou'xiong	0
欧秀	ou'xiu	0
瓯绣	ou'xiu	0
欧修特	ou'xiu'te	0
欧修弈	ou'xiu'yi	0
偶序反射	ou'xu'fan'she	0
欧轩柯	ou'xuan'ke	0
呕血	ou'xue	0
欧雪	ou'xue	0
瓯穴	ou'xue	0
呕血惊乃翁	ou'xue'jing'nai'weng	0
呕血烂柯	ou'xue'lan'ke	0
欧雪林	ou'xue'lin	0
欧雪林咖	ou'xue'lin'ka	0
欧雪林咖啡厅	ou'xue'lin'ka'fei'ting	0
偶学念奴声调	ou'xue'nian'nu'sheng'diao	0
偶学识浅薄	ou'xue'shi'qian'bo	0
欧血事酸辛	ou'xue'shi'suan'xin	0
欧洵	ou'xun	0
欧迅	ou'xun	0
偶寻陈迹到松萝	ou'xun'chen'ji'dao'song'luo	0
偶寻陈迹到烟萝	ou'xun'chen'ji'dao'yan'luo	0
欧迅进出口	ou'xun'jin'chu'kou	0
偶寻流水上崔嵬	ou'xun'liu'shui'shang'cui'wei	0
欧逊努斯海窟	ou'xun'nu'si'hai'ku	0
偶寻樵者问山名	ou'xun'qiao'zhe'wen'shan'ming	0
欧巡赛	ou'xun'sai	0
欧迅体育	ou'xun'ti'yu	0
偶寻乌府客	ou'xun'wu'fu'ke	0
偶寻野外寺	ou'xun'ye'wai'si	0
偶徇一官偷禄计	ou'xun'yi'guan'tou'lu'ji	0
欧亚	ou'ya	0
欧雅	ou'ya	0
欧亚板块	ou'ya'ban'kuai	0
欧雅壁纸	ou'ya'bi'zhi	0
欧亚宾馆	ou'ya'bin'guan	0
欧亚不锈钢	ou'ya'bu'xiu'gang	0
欧雅布艺	ou'ya'bu'yi	0
欧亚草地蝗	ou'ya'cao'di'huang	0
欧亚草地蝗指名亚种	ou'ya'cao'di'huang'zhi'ming'ya'zhong	0
欧亚超市	ou'ya'chao'shi	0
欧亚车百	ou'ya'che'bai	0
欧亚车业	ou'ya'che'ye	0
欧雅城市广场	ou'ya'cheng'shi'guang'chang	0
欧亚橱柜	ou'ya'chu'gui	0
欧雅橱柜	ou'ya'chu'gui	0
呕哑初学语	ou'ya'chu'xue'yu	0
欧亚春城	ou'ya'chun'cheng	0
欧雅村	ou'ya'cun	0
欧亚打	ou'ya'da	0
欧亚达	ou'ya'da	0
欧亚大道	ou'ya'da'dao	0
欧亚达广场	ou'ya'da'guang'chang	0
欧亚达光谷店	ou'ya'da'guang'gu'dian	0
欧亚达家居	ou'ya'da'jia'ju	0
欧亚大酒店	ou'ya'da'jiu'dian	0
欧亚大陆	ou'ya'da'lu	0
欧亚大陆内部	ou'ya'da'lu'nei'bu	0
欧亚大卖场	ou'ya'da'mai'chang	0
欧亚大厦	ou'ya'da'sha	0
欧亚达土	ou'ya'da'tu	0
欧亚达土耳其	ou'ya'da'tu'er'qi	0
欧亚的	ou'ya'de	0
欧亚灯饰	ou'ya'deng'shi	0
欧亚地震带	ou'ya'di'zhen'dai	0
欧亚店	ou'ya'dian	0
欧雅典	ou'ya'dian	0
欧亚电器	ou'ya'dian'qi	0
欧亚店庆	ou'ya'dian'qing	0
欧亚电子	ou'ya'dian'zi	0
欧亚电子大厦	ou'ya'dian'zi'da'sha	0
欧亚东街	ou'ya'dong'jie	0
欧雅尔	ou'ya'er	0
欧雅尔咖	ou'ya'er'ka	0
欧雅尔咖啡美食	ou'ya'er'ka'fei'mei'shi	0
欧亚翻译学校	ou'ya'fan'yi'xue'xiao	0
欧亚风情	ou'ya'feng'qing	0
欧亚服饰	ou'ya'fu'shi	0
欧雅服饰	ou'ya'fu'shi	0
欧亚工贸	ou'ya'gong'mao	0
欧亚公司	ou'ya'gong'si	0
欧亚购物中心	ou'ya'gou'wu'zhong'xin	0
欧亚股份	ou'ya'gu'fen	0
欧亚国际	ou'ya'guo'ji	0
欧亚国际花园	ou'ya'guo'ji'hua'yuan	0
欧亚焊菜	ou'ya'han'cai	0
欧亚河狸	ou'ya'he'li	0
欧亚红尾鸲	ou'ya'hong'wei'qu	0
藕芽胡同	ou'ya'hu'tong	0
欧亚花楸	ou'ya'hua'qiu	0
欧亚花园	ou'ya'hua'yuan	0
欧雅花园	ou'ya'hua'yuan	0
欧雅化妆品	ou'ya'hua'zhuang'pin	0
欧亚化妆品广场	ou'ya'hua'zhuang'pin'guang'chang	0
欧亚会馆	ou'ya'hui'guan	0
欧亚集	ou'ya'ji	0
欧亚集团	ou'ya'ji'tuan	0
欧雅家电	ou'ya'jia'dian	0
欧亚家具	ou'ya'jia'ju	0
欧雅家具	ou'ya'jia'ju	0
欧亚家具城	ou'ya'jia'ju'cheng	0
欧亚驾校	ou'ya'jia'xiao	0
欧亚建材	ou'ya'jian'cai	0
欧亚经济论坛	ou'ya'jing'ji'lun'tan	0
欧亚精密	ou'ya'jing'mi	0
欧亚酒店	ou'ya'jiu'dian	0
欧雅酒店	ou'ya'jiu'dian	0
欧亚九州城	ou'ya'jiu'zhou'cheng	0
欧亚卡	ou'ya'ka	0
欧亚咖	ou'ya'ka	0
欧亚咖啡	ou'ya'ka'fei	0
欧雅咖啡	ou'ya'ka'fei	0
欧亚鵟	ou'ya'kuang	0
欧亚了	ou'ya'le	0
欧雅丽	ou'ya'li	0
欧亚丽特	ou'ya'li'te	0
欧亚丽影	ou'ya'li'ying	0
欧亚连锁超市	ou'ya'lian'suo'chao'shi	0
欧亚联营	ou'ya'lian'ying	0
欧亚列当	ou'ya'lie'dang	0
欧亚柳叶蜂	ou'ya'liu'ye'feng	0
欧亚路	ou'ya'lu	0
欧亚论坛会址	ou'ya'lun'tan'hui'zhi	0
欧亚玛	ou'ya'ma	0
欧亚马	ou'ya'ma	0
欧亚卖场	ou'ya'mai'chang	0
欧亚卖场西门	ou'ya'mai'chang'xi'men	0
欧亚美	ou'ya'mei	0
欧亚美饰品	ou'ya'mei'shi'pin	0
欧亚梦都	ou'ya'meng'dou	0
欧雅名店	ou'ya'ming'dian	0
欧雅名仕	ou'ya'ming'shi	0
呕哑莫与谈	ou'ya'mo'yu'tan	0
欧亚木器	ou'ya'mu'qi	0
欧雅纳特楼梯	ou'ya'na'te'lou'ti	0
欧亚男科医院	ou'ya'nan'ke'yi'yuan	0
欧亚男子医院	ou'ya'nan'zi'yi'yuan	0
欧亚呢	ou'ya'ne	0
欧亚农业	ou'ya'nong'ye	0
欧亚皮草	ou'ya'pi'cao	0
欧亚奇	ou'ya'qi	0
欧亚槭	ou'ya'qi	0
欧亚汽车	ou'ya'qi'che	0
欧亚汽车站	ou'ya'qi'che'zhan	0
欧亚奇商人	ou'ya'qi'shang'ren	0
欧亚汽修	ou'ya'qi'xiu	0
欧亚槭瘿蚊	ou'ya'qi'ying'wen	0
欧雅墙纸	ou'ya'qiang'zhi	0
欧亚鸲	ou'ya'qu	0
欧亚犬	ou'ya'quan	0
欧亚日化	ou'ya'ri'hua	0
呕鸦软举鐶	ou'ya'ruan'ju'huan	0
欧雅若	ou'ya'ruo	0
欧亚三路万科工地	ou'ya'san'lu'wan'ke'gong'di	0
欧亚山字型构造体系	ou'ya'shan'zi'xing'gou'zao'ti'xi	0
欧亚商城	ou'ya'shang'cheng	0
欧亚商都	ou'ya'shang'du	0
欧亚商贸	ou'ya'shang'mao	0
欧亚商贸城	ou'ya'shang'mao'cheng	0
欧亚商务	ou'ya'shang'wu	0
欧亚生殖医学医院	ou'ya'sheng'zhi'yi'xue'yi'yuan	0
欧亚石材	ou'ya'shi'cai	0
欧亚束颈蝗	ou'ya'shu'jing'huang	0
欧亚水貂	ou'ya'shui'diao	0
欧亚斯国际服装公司	ou'ya'si'guo'ji'fu'zhuang'gong'si	0
欧亚松果长蝽	ou'ya'song'guo'chang'chun	0
欧亚塑机展示厅	ou'ya'su'ji'zhan'shi'ting	0
欧亚特	ou'ya'te	0
欧亚特布艺	ou'ya'te'bu'yi	0
欧亚特楼梯	ou'ya'te'lou'ti	0
欧亚提尼曼摇蚊	ou'ya'ti'ni'man'yao'wen	0
欧亚体育	ou'ya'ti'yu	0
欧亚投票	ou'ya'tou'piao	0
藕丫头虽会画	ou'ya'tou'sui'hui'hua	0
欧亚伟业	ou'ya'wei'ye	0
欧亚喜鹊	ou'ya'xi'que	0
欧亚西施	ou'ya'xi'shi	0
欧亚香花芥	ou'ya'xiang'hua'jie	0
欧亚新发	ou'ya'xin'fa	0
欧亚新发商厦	ou'ya'xin'fa'shang'sha	0
欧亚绣线菊	ou'ya'xiu'xian'ju	0
欧亚旋覆花	ou'ya'xuan'fu'hua	0
欧亚学院	ou'ya'xue'yuan	0
欧亚学院东门	ou'ya'xue'yuan'dong'men	0
欧亚学院南门	ou'ya'xue'yuan'nan'men	0
欧亚学院人文学院电视节目制作教研中心	ou'ya'xue'yuan'ren'wen'xue'yuan'dian'shi'jie'mu'zhi'zuo'jiao'yan'zhong'xin	0
欧雅眼镜	ou'ya'yan'jing	0
欧亚杨柳叶蜂	ou'ya'yang'liu'ye'feng	0
欧亚一路号	ou'ya'yi'lu'hao	0
欧亚益民	ou'ya'yi'min	0
欧亚益民商厦	ou'ya'yi'min'shang'sha	0
欧亚医院	ou'ya'yi'yuan	0
欧亚窄长蝽	ou'ya'zhai'chang'chun	0
呕哑嘲哳	ou'ya'zhao'zha	0
呕哑嘲哳难为听	ou'ya'zhao'zha'nan'wei'ting	0
欧亚之窗	ou'ya'zhi'chuang	0
欧亚之星	ou'ya'zhi'xing	0
欧亚中转站	ou'ya'zhong'zhuan'zhan	0
欧亚专利局	ou'ya'zhuan'li'ju	0
欧雅装饰材料	ou'ya'zhuang'shi'cai'liao	0
欧亚装修	ou'ya'zhuang'xiu	0
欧亚自然资源	ou'ya'zi'ran'zi'yuan	0
欧亚综合体冰雪欢乐谷	ou'ya'zong'he'ti'bing'xue'huan'le'gu	0
瓯宴	ou'yan	0
藕堰	ou'yan	0
偶湮没	ou'yan'mo	0
欧岩晓	ou'yan'xiao	0
沤厌易妇过	ou'yan'yi'fu'guo	0
欧彦悠	ou'yan'you	0
偶宴有怀	ou'yan'you'huai	0
欧扬	ou'yang	0
欧洋	ou'yang	0
欧阳	ou'yang	0
鸥阳	ou'yang	0
欧阳岸明	ou'yang'an'ming	0
欧阳白	ou'yang'bai	0
欧阳宾	ou'yang'bin	0
欧阳彬	ou'yang'bin	0
欧阳冰雪	ou'yang'bing'xue	0
欧阳泊辰	ou'yang'bo'chen	0
欧阳伯和仲纯挽词二首	ou'yang'bo'he'zhong'chun'wan'ci'er'shou	0
欧阳长恭	ou'yang'chang'gong	0
欧阳常林	ou'yang'chang'lin	0
欧阳昌琼	ou'yang'chang'qiong	0
欧阳超市	ou'yang'chao'shi	0
欧阳澈	ou'yang'che	0
欧阳冲	ou'yang'chong	0
欧阳春	ou'yang'chun	0
欧阳椿	ou'yang'chun	0
欧阳村	ou'yang'cun	0
欧阳大厦	ou'yang'da'sha	0
欧阳大叔	ou'yang'da'shu	0
欧阳当	ou'yang'dang	0
欧阳德	ou'yang'de	0
欧阳地段医院	ou'yang'di'duan'yi'yuan	0
欧阳地馀	ou'yang'di'yu	0
欧阳丁	ou'yang'ding	0
欧阳毒物	ou'yang'du'wu	0
欧阳飞	ou'yang'fei	0
欧阳菲菲	ou'yang'fei'fei	0
欧阳飞霞	ou'yang'fei'xia	0
欧阳峰	ou'yang'feng	0
欧阳锋	ou'yang'feng	0
欧阳辅棠	ou'yang'fu'tang	0
欧阳刚	ou'yang'gang	0
欧阳高	ou'yang'gao	0
欧阳工匠	ou'yang'gong'jiang	0
欧阳公南还佐是邦而为此斋	ou'yang'gong'nan'hai'zuo'shi'bang'er'wei'ci'zhai	0
欧阳公所蓄石屏	ou'yang'gong'suo'xu'shi'ping	0
欧阳公寓	ou'yang'gong'yu	0
欧阳公政	ou'yang'gong'zheng	0
欧阳观	ou'yang'guan	0
欧阳光祖	ou'yang'guang'zu	0
欧阳贵	ou'yang'gui	0
欧阳衮	ou'yang'gun	0
欧阳果	ou'yang'guo	0
欧阳国璋	ou'yang'guo'zhang	0
欧阳海	ou'yang'hai	0
欧阳海村	ou'yang'hai'cun	0
欧阳海灌区	ou'yang'hai'guan'qu	0
欧阳海广场	ou'yang'hai'guang'chang	0
欧阳海乡	ou'yang'hai'xiang	0
欧央行理事	ou'yang'hang'li'shi	0
欧阳恒	ou'yang'heng	0
欧阳宏	ou'yang'hong	0
欧阳鸿	ou'yang'hong	0
欧阳湖	ou'yang'hu	0
欧阳湖南	ou'yang'hu'nan	0
欧阳湖南土菜馆	ou'yang'hu'nan'tu'cai'guan	0
欧阳画	ou'yang'hua	0
欧阳花	ou'yang'hua	0
欧阳华明	ou'yang'hua'ming	0
欧阳花园	ou'yang'hua'yuan	0
欧阳花苑	ou'yang'hua'yuan	0
欧阳慧	ou'yang'hui	0
欧阳晦夫惠琴枕	ou'yang'hui'fu'hui'qin'zhen	0
欧阳晦夫遗接琴枕戏作此诗谢之	ou'yang'hui'fu'yi'jie'qin'zhen'xi'zuo'ci'shi'xie'zhi	0
欧阳惠卿	ou'yang'hui'qing	0
欧阳慧诗	ou'yang'hui'shi	0
欧阳季	ou'yang'ji	0
欧阳急	ou'yang'ji	0
欧阳机电	ou'yang'ji'dian	0
欧阳佳	ou'yang'jia	0
欧阳家	ou'yang'jia	0
欧阳家的小虎	ou'yang'jia'de'xiao'hu	0
欧阳建	ou'yang'jian	0
欧阳渐	ou'yang'jian	0
欧阳建华	ou'yang'jian'hua	0
欧阳建民	ou'yang'jian'min	0
欧阳江河	ou'yang'jiang'he	0
欧阳脚	ou'yang'jiao	0
欧阳焦组	ou'yang'jiao'zu	0
欧阳姐	ou'yang'jie	0
欧阳杰	ou'yang'jie	0
欧阳界	ou'yang'jie	0
欧阳结体三十六法	ou'yang'jie'ti'san'shi'liu'fa	0
欧阳瑾	ou'yang'jin	0
欧阳金成	ou'yang'jin'cheng	0
欧阳敬	ou'yang'jing	0
欧阳晶	ou'yang'jing	0
欧阳菁	ou'yang'jing	0
欧阳靖	ou'yang'jing	0
欧阳竞无	ou'yang'jing'wu	0
欧阳竟无	ou'yang'jing'wu	0
欧阳炯	ou'yang'jiong	0
欧阳巨源	ou'yang'ju'yuan	0
欧阳均	ou'yang'jun	0
欧阳恺文	ou'yang'kai'wen	0
欧阳康	ou'yang'kang	0
欧阳克	ou'yang'ke	0
欧阳可	ou'yang'ke	0
欧阳阔	ou'yang'kuo	0
欧阳老师	ou'yang'lao'shi	0
欧阳离离	ou'yang'li'li	0
欧阳廪	ou'yang'lin	0
欧阳林杰	ou'yang'lin'jie	0
欧阳岭	ou'yang'ling	0
欧阳龙	ou'yang'long	0
欧阳楼	ou'yang'lou	0
欧阳禄	ou'yang'lu	0
欧阳路	ou'yang'lu	0
欧阳路大连西路	ou'yang'lu'da'lian'xi'lu	0
欧阳路公房	ou'yang'lu'gong'fang	0
欧阳路航	ou'yang'lu'hang	0
欧阳路号	ou'yang'lu'hao	0
欧阳路吉祥路	ou'yang'lu'ji'xiang'lu	0
欧阳路街道	ou'yang'lu'jie'dao	0
欧阳路街道老年学校	ou'yang'lu'jie'dao'lao'nian'xue'xiao	0
欧阳路弄	ou'yang'lu'nong	0
欧阳路派出所	ou'yang'lu'pai'chu'suo	0
欧阳路四达路	ou'yang'lu'si'da'lu	0
欧阳路祥德路	ou'yang'lu'xiang'de'lu	0
欧仰麦	ou'yang'mai	0
欧洋门诊	ou'yang'men'zhen	0
欧阳妙	ou'yang'miao	0
欧阳妙琴	ou'yang'miao'qin	0
欧阳忞	ou'yang'min	0
欧阳明	ou'yang'ming	0
欧阳名邸	ou'yang'ming'di	0
欧阳名店	ou'yang'ming'dian	0
欧阳明昊	ou'yang'ming'hao	0
欧阳明利	ou'yang'ming'li	0
欧阳明珠	ou'yang'ming'zhu	0
欧阳墨宝	ou'yang'mo'bao	0
欧阳穆穆	ou'yang'mu'mu	0
欧阳牧之	ou'yang'mu'zhi	0
欧阳娜娜	ou'yang'na'na	0
欧阳暖	ou'yang'nuan	0
欧阳诺一	ou'yang'nuo'yi	0
欧阳辟	ou'yang'pi	0
欧阳玭	ou'yang'pin	0
欧阳坡	ou'yang'po	0
欧阳铺	ou'yang'pu	0
欧阳琦	ou'yang'qi	0
欧阳琦琳	ou'yang'qi'lin	0
欧阳倩	ou'yang'qian	0
欧阳倩予编剧	ou'yang'qian'yu'bian'ju	0
欧阳桥	ou'yang'qiao	0
欧阳巧玲	ou'yang'qiao'ling	0
欧阳钦	ou'yang'qin	0
欧阳青	ou'yang'qing	0
欧阳擎天	ou'yang'qing'tian	0
欧阳蜻庭	ou'yang'qing'ting	0
欧阳弱而立	ou'yang'ruo'er'li	0
欧阳若谷	ou'yang'ruo'gu	0
欧阳若曦	ou'yang'ruo'xi	0
欧阳若愚	ou'yang'ruo'yu	0
欧阳山	ou'yang'shan	0
欧阳尚书	ou'yang'shang'shu	0
欧阳上智	ou'yang'shang'zhi	0
欧阳少恭	ou'yang'shao'gong	0
欧阳少恭少恭	ou'yang'shao'gong'shao'gong	0
欧阳少师令赋所蓄石屏	ou'yang'shao'shi'ling'fu'suo'xu'shi'ping	0
欧阳少游	ou'yang'shao'you	0
欧洋歙	ou'yang'she	0
欧阳燊	ou'yang'shen	0
欧阳圣	ou'yang'sheng	0
欧阳生	ou'yang'sheng	0
欧阳笙	ou'yang'sheng	0
欧阳胜天	ou'yang'sheng'tian	0
欧阳侍郎	ou'yang'shi'lang	0
欧阳淑敏	ou'yang'shu'min	0
欧阳霜	ou'yang'shuang	0
欧阳寺村	ou'yang'si'cun	0
欧阳思婷	ou'yang'si'ting	0
欧阳酸	ou'yang'suan	0
欧阳酸汤	ou'yang'suan'tang	0
欧阳酸汤鱼	ou'yang'suan'tang'yu	0
欧阳台	ou'yang'tai	0
欧阳太师挽词三首	ou'yang'tai'shi'wan'ci'san'shou	0
欧阳塘	ou'yang'tang	0
欧阳腾	ou'yang'teng	0
欧阳天矫	ou'yang'tian'jiao	0
欧阳天热	ou'yang'tian're	0
欧阳铁手	ou'yang'tie'shou	0
欧阳通	ou'yang'tong	0
欧阳团安	ou'yang'tuan'an	0
欧阳卫	ou'yang'wei	0
欧阳威	ou'yang'wei	0
欧阳为佳	ou'yang'wei'jia	0
欧阳文伯	ou'yang'wen'bo	0
欧阳文乙男	ou'yang'wen'yi'nan	0
欧阳文仲	ou'yang'wen'zhong	0
欧阳文忠公尝云王勃记文似俳	ou'yang'wen'zhong'gong'chang'yun'wang'bo'ji'wen'si'pai	0
欧阳文忠公夫人挽词二首	ou'yang'wen'zhong'gong'fu'ren'wan'ci'er'shou	0
欧阳文忠公集	ou'yang'wen'zhong'gong'ji	0
欧阳文忠公文	ou'yang'wen'zhong'gong'wen	0
欧阳屋	ou'yang'wu	0
欧阳悟	ou'yang'wu	0
欧阳无畏	ou'yang'wu'wei	0
欧阳喜	ou'yang'xi	0
欧阳溪	ou'yang'xi	0
欧阳夏侯遗说考	ou'yang'xia'hou'yi'shuo'kao	0
欧阳先生	ou'yang'xian'sheng	0
欧阳巷	ou'yang'xiang	0
欧阳相士谒书诣梁权郡诗以代之	ou'yang'xiang'shi'ye'shu'yi'liang'quan'jun'shi'yi'dai'zhi	0
欧阳晓静	ou'yang'xiao'jing	0
欧阳小区	ou'yang'xiao'qu	0
欧阳澥	ou'yang'xie	0
欧阳行州文集	ou'yang'xing'zhou'wen'ji	0
欧阳兄弟	ou'yang'xiong'di	0
欧阳雄华	ou'yang'xiong'hua	0
欧阳修	ou'yang'xiu	0
欧阳修祠	ou'yang'xiu'ci	0
欧阳修的传说	ou'yang'xiu'de'chuan'shuo	0
欧阳修公园	ou'yang'xiu'gong'yuan	0
欧阳修广场	ou'yang'xiu'guang'chang	0
欧阳修陵园	ou'yang'xiu'ling'yuan	0
欧阳秀芝	ou'yang'xiu'zhi	0
欧阳修字什么答案永叔	ou'yang'xiu'zi'shen'me'da'an'yong'shu	0
欧阳序	ou'yang'xu	0
欧阳旭	ou'yang'xu	0
欧阳玄	ou'yang'xuan	0
欧阳勋	ou'yang'xun	0
欧阳珣	ou'yang'xun	0
欧阳询	ou'yang'xun	0
欧阳询三十六法	ou'yang'xun'san'shi'liu'fa	0
欧阳亚琴诊所	ou'yang'ya'qin'zhen'suo	0
欧阳雅诗	ou'yang'ya'shi	0
欧阳彦华	ou'yang'yan'hua	0
欧阳烨柏	ou'yang'ye'bai	0
欧阳应霁	ou'yang'ying'ji	0
欧阳泳	ou'yang'yong	0
欧阳永叔	ou'yang'yong'shu	0
欧阳永叔尝游嵩山	ou'yang'yong'shu'chang'you'song'shan	0
欧阳永叔所建	ou'yang'yong'shu'suo'jian	0
欧阳永叔闻君谟进小龙团	ou'yang'yong'shu'wen'jun'mo'jin'xiao'long'tuan	0
欧阳宇	ou'yang'yu	0
欧阳玉	ou'yang'yu	0
欧阳遇	ou'yang'yu	0
欧阳予倩	ou'yang'yu'qian	0
欧阳予倩故居	ou'yang'yu'qian'gu'ju	0
欧阳予倩剧院	ou'yang'yu'qian'ju'yuan	0
欧阳裕仁	ou'yang'yu'ren	0
欧阳遇实验中学	ou'yang'yu'shi'yan'zhong'xue	0
欧阳袁源	ou'yang'yuan'yuan	0
欧阳月格	ou'yang'yue'ge	0
欧阳月兮	ou'yang'yue'xi	0
欧阳云书	ou'yang'yun'shu	0
欧阳云天	ou'yang'yun'tian	0
欧阳造型	ou'yang'zao'xing	0
欧阳詹	ou'yang'zhan	0
欧阳章	ou'yang'zhang	0
欧阳掌柜	ou'yang'zhang'gui	0
欧阳赵陈皆我有	ou'yang'zhao'chen'jie'wo'you	0
欧阳赵陈在户外	ou'yang'zhao'chen'zai'hu'wai	0
欧阳朝阳	ou'yang'zhao'yang	0
欧阳贞	ou'yang'zhen	0
欧阳振干	ou'yang'zhen'gan	0
欧阳震华	ou'yang'zhen'hua	0
欧阳振乾	ou'yang'zhen'qian	0
欧阳诊所	ou'yang'zhen'suo	0
欧阳政	ou'yang'zheng	0
欧阳志	ou'yang'zhi	0
欧阳智	ou'yang'zhi	0
欧阳中石	ou'yang'zhong'shi	0
欧阳中西医诊所	ou'yang'zhong'xi'yi'zhen'suo	0
欧阳庄	ou'yang'zhuang	0
欧阳子昌	ou'yang'zi'chang	0
欧阳子方夜读书	ou'yang'zi'fang'ye'du'shu	0
欧窑	ou'yao	0
瓯窑	ou'yao	0
讴谣	ou'yao	0
偶邀礼数车上足	ou'yao'li'shu'che'shang'zu	0
讴谣满百城	ou'yao'man'bai'cheng	0
欧摇朴	ou'yao'pu	0
讴谣人扑地	ou'yao'ren'pu'di	0
讴摇喧井邑	ou'yao'xuan'jing'yi	0
讴谣喧井邑	ou'yao'xuan'jing'yi	0
偶爷	ou'ye	0
偶野	ou'ye	0
欧业	ou'ye	0
欧叶	ou'ye	0
欧夜	ou'ye	0
欧野	ou'ye	0
偶谒大中精蓝中	ou'ye'da'zhong'jing'lan'zhong	0
欧夜蛾属	ou'ye'e'shu	0
欧耶胡	ou'ye'hu	0
欧叶莱	ou'ye'lai	0
欧也妮葛兰台	ou'ye'ni'ge'lan'tai	0
欧也妮葛朗台	ou'ye'ni'ge'lang'tai	0
偶也偶	ou'ye'ou	0
偶也忘了	ou'ye'wang'le	0
偶也系	ou'ye'xi	0
偶也姓赵	ou'ye'xing'zhao	0
欧夜休闲吧	ou'ye'xiu'xian'ba	0
欧夜鹰	ou'ye'ying	0
偶也这么认为	ou'ye'zhe'me'ren'wei	0
欧冶子	ou'ye'zi	0
欧冶子别院	ou'ye'zi'bie'yuan	0
欧冶子死千年后	ou'ye'zi'si'qian'nian'hou	0
欧冶子再世	ou'ye'zi'zai'shi	0
欧冶子铸剑	ou'ye'zi'zhu'jian	0
欧亦	ou'yi	0
欧亿	ou'yi	0
欧奕	ou'yi	0
欧姨	ou'yi	0
欧意	ou'yi	0
欧艺	ou'yi	0
蕅益	ou'yi	0
藕益	ou'yi	0
欧易遨	ou'yi'ao	0
欧意宝	ou'yi'bao	0
欧一博	ou'yi'bo	0
欧伊博	ou'yi'bo	0
欧艺橱柜	ou'yi'chu'gui	0
欧意厨具	ou'yi'chu'ju	0
欧意厨卫	ou'yi'chu'wei	0
欧伊茨亚	ou'yi'ci'ya	0
欧艺大酒店	ou'yi'da'jiu'dian	0
蕅益大师	ou'yi'da'shi	0
藕益大师	ou'yi'da'shi	0
欧意达珠宝首饰公司	ou'yi'da'zhu'bao'shou'shi'gong'si	0
偶亦得此生	ou'yi'de'ci'sheng	0
欧意电器	ou'yi'dian'qi	0
欧伊尔	ou'yi'er	0
欧伊尔的母亲	ou'yi'er'de'mu'qin	0
欧衣阁	ou'yi'ge	0
偶意共逸韵俱发	ou'yi'gong'yi'yun'ju'fa	0
欧意皇	ou'yi'huang	0
欧意皇式	ou'yi'huang'shi	0
欧意皇式咖啡	ou'yi'huang'shi'ka'fei	0
欧艺珈	ou'yi'jia	0
欧艺家家私制造厂	ou'yi'jia'jia'si'zhi'zao'chang	0
欧亦健身	ou'yi'jian'shen	0
欧艺酒店	ou'yi'jiu'dian	0
欧亿咖	ou'yi'ka	0
欧亿咖啡	ou'yi'ka'fei	0
欧伊克洛伊	ou'yi'ke'luo'yi	0
欧逸丽庭	ou'yi'li'ting	0
欧姨妈	ou'yi'ma	0
欧姨妈火	ou'yi'ma'huo	0
欧姨妈火锅排挡	ou'yi'ma'huo'guo'pai'dang	0
欧依曼	ou'yi'man	0
欧依美精品女装	ou'yi'mei'jing'pin'nv'zhuang	0
欧意美沙发	ou'yi'mei'sha'fa	0
欧宜敏	ou'yi'min	0
欧伊莫	ou'yi'mo	0
呕已乃衰	ou'yi'nai'shuai	0
欧伊尼肯	ou'yi'ni'ken	0
欧一派	ou'yi'pai	0
偶忆平生事	ou'yi'ping'sheng'shi	0
鸥翼切平面	ou'yi'qie'ping'mian	0
欧宜情服饰名店	ou'yi'qing'fu'shi'ming'dian	0
欧依莎	ou'yi'sha	0
偶亦识画旨	ou'yi'shi'hua'zhi	0
欧艺时尚窗帘	ou'yi'shi'shang'chuang'lian	0
偶以事至蕲水	ou'yi'shi'zhi'qi'shui	0
欧逸水岸	ou'yi'shui'an	0
欧伊特莱尔	ou'yi'te'lai'er	0
欧艺铁饰	ou'yi'tie'shi	0
欧奕投资	ou'yi'tou'zi	0
偶一为之	ou'yi'wei'zhi	0
欧意轩	ou'yi'xuan	0
欧意轩花园	ou'yi'xuan'hua'yuan	0
偶以一书笈	ou'yi'yi'shu'ji	0
偶依一株树	ou'yi'yi'zhu'shu	0
偶亦有所窥	ou'yi'you'suo'kui	0
欧意园林	ou'yi'yuan'lin	0
欧艺装饰	ou'yi'zhuang'shi	0
偶遗子亦自成花	ou'yi'zi'yi'zi'cheng'hua	0
偶吟	ou'yin	0
偶饮	ou'yin	0
欧因	ou'yin	0
讴吟不能已	ou'yin'bu'neng'yi	0
偶因独见空惊目	ou'yin'du'jian'kong'jing'mu	0
偶因耳目好	ou'yin'er'mu'hao	0
偶吟二首	ou'yin'er'shou	0
欧因哥	ou'yin'ge	0
欧银贺	ou'yin'he	0
偶因回舟次	ou'yin'hui'zhou'ci	0
偶因济刘氏	ou'yin'ji'liu'shi	0
偶因冷节会嘉宾	ou'yin'leng'jie'hui'jia'bin	0
偶因麋鹿随丰草	ou'yin'mi'lu'sui'feng'cao	0
偶因明月清风夜	ou'yin'ming'yue'qing'feng'ye	0
偶因群动息	ou'yin'qun'dong'xi	0
偶引群仙到世间	ou'yin'qun'xian'dao'shi'jian	0
讴吟任所须	ou'yin'ren'suo'xu	0
讴吟坰野	ou'yin'shang'ye	0
讴吟思归出无计	ou'yin'si'gui'chu'wu'ji	0
偶因送客到龙山	ou'yin'song'ke'dao'long'shan	0
偶因送客上西楼	ou'yin'song'ke'shang'xi'lou	0
偶吟所怀	ou'yin'suo'huai	0
讴吟土风	ou'yin'tu'feng	0
偶因微雨点苍苔	ou'yin'wei'yu'dian'cang'tai	0
偶因闲步散顽麻	ou'yin'xian'bu'san'wan'ma	0
偶因衔泥处	ou'yin'xian'ni'chu	0
偶因小泊处	ou'yin'xiao'bo'chu	0
偶因携酒寻村客	ou'yin'xie'jiu'xun'cun'ke	0
偶因行药过墙阴	ou'yin'xing'yao'guo'qiang'yin	0
偶因一着错	ou'yin'yi'zhao'cuo	0
讴吟辄尝赓	ou'yin'zhe'chang'geng	0
欧影	ou'ying	0
欧营	ou'ying	0
謳硬	ou'ying	0
鸥迎出浦桡	ou'ying'chu'pu'rao	0
欧营村	ou'ying'cun	0
偶影独游	ou'ying'du'you	0
偶应非熊兆	ou'ying'fei'xiong'zhao	0
欧盈光电	ou'ying'guang'dian	0
欧英文	ou'ying'wen	0
欧缨小蜂	ou'ying'xiao'feng	0
欧英央行	ou'ying'yang'hang	0
偶哟	ou'yo	0
偶哟喂	ou'yo'wei	0
偶咏	ou'yong	0
欧涌	ou'yong	0
鸥涌	ou'yong	0
欧涌村	ou'yong'cun	0
鸥涌村	ou'yong'cun	0
鸥涌湾双色威化草莓味饼干糕点	ou'yong'wan'shuang'se'wei'hua'cao'mei'wei'bing'gan'gao'dian	0
鸥涌湾双色威化香橙味饼干糕点	ou'yong'wan'shuang'se'wei'hua'xiang'cheng'wei'bing'gan'gao'dian	0
偶油	ou'you	0
呕呦	ou'you	0
呕油	ou'you	0
欧幼	ou'you	0
欧由	ou'you	0
偶有冲天气	ou'you'chong'tian'qi	0
偶游洞府到芝田	ou'you'dong'fu'dao'zhi'tian	0
偶游方自得	ou'you'fang'zi'de	0
偶游滑台侧	ou'you'hua'tai'ce	0
呕有苦	ou'you'ku	0
欧幽莱瑞	ou'you'lai'rui	0
欧幽洛雪	ou'you'luo'xue	0
偶有名酒	ou'you'ming'jiu	0
欧幽幕瑞	ou'you'mu'rui	0
偶游难得伴	ou'you'nan'de'ban	0
偶有清樽供寿母	ou'you'qing'zun'gong'shou'mu	0
偶游身独自	ou'you'shen'du'zi	0
偶游石盎僧舍	ou'you'shi'ang'seng'she	0
偶有属性	ou'you'shu'xing	0
偶有物料	ou'you'wu'liao	0
欧游心影录	ou'you'xin'ying'lu	0
偶又要等很久	ou'you'yao'deng'hen'jiu	0
偶又游至维扬地面	ou'you'you'zhi'wei'yang'di'mian	0
偶寓	ou'yu	0
偶遇	ou'yu	0
欧宇	ou'yu	0
欧虞	ou'yu	0
欧语	ou'yu	0
瓯遇	ou'yu	0
偶遇吧	ou'yu'ba	0
欧郁焙	ou'yu'bei	0
偶欲陈此意	ou'yu'chen'ci'yi	0
偶与城市远	ou'yu'cheng'shi'yuan	0
偶宇称性	ou'yu'cheng'xing	0
偶遇抽样	ou'yu'chou'yang	0
偶遇春意	ou'yu'chun'yi	0
欧峪村	ou'yu'cun	0
偶与儿曹翻故纸	ou'yu'er'cao'fan'gu'zhi	0
偶遇分枝杆菌	ou'yu'fen'zhi'gan'jun	0
欧宇峰	ou'yu'feng	0
偶欲观书又懒开	ou'yu'guan'shu'you'lan'kai	0
偶遇极恶少年	ou'yu'ji'e'shao'nian	0
偶迂假说	ou'yu'jia'shuo	0
欧虞兼褚薛	ou'yu'jian'zhu'xue	0
欧榆蚧蚜小蜂	ou'yu'jie'ya'xiao'feng	0
偶遇酒吧	ou'yu'jiu'ba	0
偶遇聚	ou'yu'ju	0
偶遇来	ou'yu'lai	0
欧圫里	ou'yu'li	0
偶遇灵溪	ou'yu'ling'xi	0
欧玉龙	ou'yu'long	0
偶与乱石会	ou'yu'luan'shi'hui	0
欧虞缅谁嗣	ou'yu'mian'shui'si	0
偶语弃市	ou'yu'qi'shi	0
偶与潜夫论	ou'yu'qian'fu'lun	0
偶与前山通	ou'yu'qian'shan'tong	0
偶与樵夫会	ou'yu'qiao'fu'hui	0
偶与琼瑶亲	ou'yu'qiong'yao'qin	0
偶与群公游	ou'yu'qun'gong'you	0
偶遇闰秋重九日	ou'yu'run'qiu'chong'jiu'ri	0
偶遇伤心	ou'yu'shang'xin	0
欧宇陶瓷	ou'yu'tao'ci	0
偶遇我	ou'yu'wo	0
偶与息心侣	ou'yu'xi'xin'lv	0
偶遇现代爱情	ou'yu'xian'dai'ai'qing	0
偶语闲攀芳树立	ou'yu'xian'pan'fang'shu'li	0
偶遇鞋吧	ou'yu'xie'ba	0
偶与心相通	ou'yu'xin'xiang'tong	0
偶遇信悠哉	ou'yu'xin'you'zai	0
偶与匈奴逢	ou'yu'xiong'nu'feng	0
欧虞颜柳	ou'yu'yan'liu	0
偶与长者并	ou'yu'zhang'zhe'bing	0
偶与真意并	ou'yu'zhen'yi'bing	0
偶与支公邻	ou'yu'zhi'gong'lin	0
偶与支公论	ou'yu'zhi'gong'lun	0
偶馀尊酒在	ou'yu'zun'jiu'zai	0
偶园	ou'yuan	0
欧元	ou'yuan	0
欧园	ou'yuan	0
欧源	ou'yuan	0
耦园	ou'yuan	0
欧园北欧印象	ou'yuan'bei'ou'yin'xiang	0
欧源大道	ou'yuan'da'dao	0
欧元兑美元	ou'yuan'dui'mei'yuan	0
欧元兑瑞郎	ou'yuan'dui'rui'lang	0
欧元兑英镑	ou'yuan'dui'ying'bang	0
欧圆耳柳卷叶蜂	ou'yuan'er'liu'juan'ye'feng	0
偶原街	ou'yuan'jie	0
偶园街	ou'yuan'jie	0
欧元卡	ou'yuan'ka	0
欧元区	ou'yuan'qu	0
欧元区服务业	ou'yuan'qu'fu'wu'ye	0
欧元区各国	ou'yuan'qu'ge'guo	0
欧元区货币市场	ou'yuan'qu'huo'bi'shi'chang	0
欧元区经济	ou'yuan'qu'jing'ji	0
欧元区通胀率	ou'yuan'qu'tong'zhang'lv	0
欧元区主导利率	ou'yuan'qu'zhu'dao'li'lv	0
欧元同业拆借利率	ou'yuan'tong'ye'chai'jie'li'lv	0
欧园小区	ou'yuan'xiao'qu	0
欧元银行同业隔夜拆息	ou'yuan'yin'hang'tong'ye'ge'ye'chai'xi	0
欧元英镑	ou'yuan'ying'bang	0
欧元硬币清分机	ou'yuan'ying'bi'qing'fen'ji	0
偶缘犹未忘多情	ou'yuan'you'wei'wang'duo'qing	0
欧元债券	ou'yuan'zhai'quan	0
欧元指数	ou'yuan'zhi'shu	0
藕圆子	ou'yuan'zi	0
欧元走势	ou'yuan'zou'shi	0
欧越	ou'yue	0
欧越餐	ou'yue'can	0
欧越餐饮	ou'yue'can'yin	0
瓯越归谈笑	ou'yue'gui'tan'xiao	0
歐樂金拉德	ou'yue'jin'la'de	0
欧约伦	ou'yue'lun	0
瓯越明珠	ou'yue'ming'zhu	0
欧越年	ou'yue'nian	0
欧越年代	ou'yue'nian'dai	0
瓯粤迫兹守	ou'yue'po'zi'shou	0
瓯越委琴瑟	ou'yue'wei'qin'se	0
欧月庄园滑草场	ou'yue'zhuang'yuan'hua'cao'chang	0
欧允	ou'yun	0
欧运	ou'yun	0
欧韵	ou'yun	0
欧韵宾馆	ou'yun'bin'guan	0
欧韵城	ou'yun'cheng	0
偶运非彭泽	ou'yun'fei'peng'ze	0
欧韵公园	ou'yun'gong'yuan	0
欧韵公园东门	ou'yun'gong'yuan'dong'men	0
欧韵诺威	ou'yun'nuo'wei	0
欧运舜	ou'yun'shun	0
欧韵艺墅	ou'yun'yi'shu	0
偶仔	ou'zai	0
呕在	ou'zai	0
欧宰尔	ou'zai'er	0
偶在看电视	ou'zai'kan'dian'shi	0
偶在旁观你啊	ou'zai'pang'guan'ni'a	0
欧赞依	ou'zan'yi	0
偶造	ou'zao	0
怄躁	ou'zao	0
偶遭蛊虿之谗	ou'zao'gu'chai'zhi'chan	0
欧泽君	ou'ze'jun	0
欧泽鲁克	ou'ze'lu'ke	0
呕则逆	ou'ze'ni	0
欧泽芹	ou'ze'qin	0
偶怎么也	ou'zen'me'ye	0
偶赠绝句	ou'zeng'jue'ju	0
欧扎	ou'zha	0
欧楂	ou'zha	0
欧扎克高原	ou'zha'ke'gao'yuan	0
欧扎克山	ou'zha'ke'shan	0
欧扎克山脉	ou'zha'ke'shan'mai	0
欧宅	ou'zhai	0
欧寨	ou'zhai	0
欧寨村	ou'zhai'cun	0
鸥斋石墨题跋	ou'zhai'shi'mo'ti'ba	0
欧展	ou'zhan	0
欧战	ou'zhan	0
欧展昂	ou'zhan'ang	0
欧展鸿	ou'zhan'hong	0
呕者	ou'zhe	0
欧哲	ou'zhe	0
殴者	ou'zhe	0
呕者复内半夏	ou'zhe'fu'nei'ban'xia	0
呕者加半夏五合	ou'zhe'jia'ban'xia'wu'he	0
沤者求深源	ou'zhe'qiu'shen'yuan	0
偶着儒冠敢陋今	ou'zhe'ru'guan'gan'lou'jin	0
欧震	ou'zhen	0
欧甄项曲	ou'zhen'xiang'qu	0
欧证	ou'zheng	0
殴正	ou'zheng	0
欧治	ou'zhi	0
欧直	ou'zhi	0
偶之不去则反佐以取之	ou'zhi'bu'qu'ze'fan'zuo'yi'qu'zhi	0
偶值乘篮舆	ou'zhi'cheng'lan'yu	0
偶栉大蚊属	ou'zhi'da'wen'shu	0
偶值当途石	ou'zhi'dang'tu'shi	0
藕汁地汁牛乳研	ou'zhi'di'zhi'niu'ru'yan	0
欧志峰	ou'zhi'feng	0
偶值高僧出	ou'zhi'gao'seng'chu	0
偶置换	ou'zhi'huan	0
欧志辉	ou'zhi'hui	0
欧之联电缆有限公司	ou'zhi'lian'dian'lan'you'xian'gong'si	0
偶质量数	ou'zhi'liang'shu	0
偶值灵秀之气适过	ou'zhi'ling'xiu'zhi'qi'shi'guo	0
偶值门开暂相逐	ou'zhi'men'kai'zan'xiang'zhu	0
欧智宁	ou'zhi'ning	0
偶值栖遁迹	ou'zhi'qi'dun'ji	0
偶至情更适	ou'zhi'qing'geng'shi	0
偶痣三叉蚜茧蜂	ou'zhi'san'cha'ya'jian'feng	0
欧芷欣	ou'zhi'xin	0
欧之星	ou'zhi'xing	0
偶至因成宿	ou'zhi'yin'cheng'xiu	0
偶只用	ou'zhi'yong	0
欧治于	ou'zhi'yu	0
鸥知远客心	ou'zhi'yuan'ke'xin	0
欧之云	ou'zhi'yun	0
欧之韵	ou'zhi'yun	0
欧芝芝	ou'zhi'zhi	0
偶之制也	ou'zhi'zhi'ye	0
偶知珠在手	ou'zhi'zhu'zai'shou	0
偶中	ou'zhong	0
欧忠翠组	ou'zhong'cui'zu	0
偶种得成阴	ou'zhong'de'cheng'yin	0
欧中广场	ou'zhong'guang'chang	0
欧中建	ou'zhong'jian	0
欧中文化艺术商业信息交流中心兰州办事处	ou'zhong'wen'hua'yi'shu'shang'ye'xin'xi'jiao'liu'zhong'xin'lan'zhou'ban'shi'chu	0
耦中有耦	ou'zhong'you'ou	0
偶种竹成俱崛强	ou'zhong'zhu'cheng'ju'jue'qiang	0
欧洲	ou'zhou	0
鸥洲	ou'zhou	0
欧洲鮟鱇	ou'zhou'an'kang	0
欧洲安全与合作会议	ou'zhou'an'quan'yu'he'zuo'hui'yi	0
欧洲拜耳法	ou'zhou'bai'er'fa	0
欧洲白桦扁叶蜂	ou'zhou'bai'hua'bian'ye'feng	0
欧洲白桦潜叶细蛾	ou'zhou'bai'hua'qian'ye'xi'e	0
欧洲白桦叶蜂	ou'zhou'bai'hua'ye'feng	0
欧洲白蜡灰木虱	ou'zhou'bai'la'hui'mu'shi	0
欧洲白蜡绒粉蚧	ou'zhou'bai'la'rong'fen'jie	0
欧洲白蜡树巢蛾	ou'zhou'bai'la'shu'chao'e	0
欧洲白蜡树瘿蚊	ou'zhou'bai'la'shu'ying'wen	0
欧洲白蜡叶蜂	ou'zhou'bai'la'ye'feng	0
欧洲白栎细蛾	ou'zhou'bai'li'xi'e	0
欧洲白栎叶蜂	ou'zhou'bai'li'ye'feng	0
欧洲白杨	ou'zhou'bai'yang	0
欧洲白榆	ou'zhou'bai'yu	0
欧洲斑蝎蛉	ou'zhou'ban'xie'ling	0
欧洲报春	ou'zhou'bao'chun	0
欧洲杯	ou'zhou'bei	0
欧洲北部	ou'zhou'bei'bu	0
欧洲杯首秀	ou'zhou'bei'shou'xiu	0
欧洲杯完整赛程表	ou'zhou'bei'wan'zheng'sai'cheng'biao	0
欧洲杯志愿者	ou'zhou'bei'zhi'yuan'zhe	0
欧洲壁纸精品店	ou'zhou'bi'zhi'jing'pin'dian	0
欧洲标准	ou'zhou'biao'zhun	0
欧洲伯劳	ou'zhou'bo'lao	0
欧洲伯劳的发现	ou'zhou'bo'lao'de'fa'xian	0
欧洲苍耳	ou'zhou'cang'er	0
欧洲操帆手男装	ou'zhou'cao'fan'shou'nan'zhuang	0
欧洲操帆手女装	ou'zhou'cao'fan'shou'nv'zhuang	0
欧洲蟾	ou'zhou'chan	0
欧洲产权证券市场	ou'zhou'chan'quan'zheng'quan'shi'chang	0
欧洲常规用途	ou'zhou'chang'gui'yong'tu	0
欧洲超级杯	ou'zhou'chao'ji'bei	0
欧洲陈	ou'zhou'chen	0
欧州城	ou'zhou'cheng	0
欧洲城	ou'zhou'cheng	0
欧洲城大酒店	ou'zhou'cheng'da'jiu'dian	0
欧洲城大门口	ou'zhou'cheng'da'men'kou	0
欧洲城二期	ou'zhou'cheng'er'qi	0
欧洲城蛇馆	ou'zhou'cheng'she'guan	0
欧洲城中心内环	ou'zhou'cheng'zhong'xin'nei'huan	0
欧洲城中心外环	ou'zhou'cheng'zhong'xin'wai'huan	0
欧洲城中央百货大楼	ou'zhou'cheng'zhong'yang'bai'huo'da'lou	0
欧洲城总站	ou'zhou'cheng'zong'zhan	0
欧洲吃	ou'zhou'chi	0
欧洲赤松	ou'zhou'chi'song	0
欧洲赤松的发现	ou'zhou'chi'song'de'fa'xian	0
欧洲赤松卷蛾属	ou'zhou'chi'song'juan'e'shu	0
欧洲赤松叶蜂	ou'zhou'chi'song'ye'feng	0
欧洲赤杨潜叶蜂	ou'zhou'chi'yang'qian'ye'feng	0
欧洲出版商摄影奖	ou'zhou'chu'ban'shang'she'ying'jiang	0
欧洲刺柏	ou'zhou'ci'bai	0
欧洲词典制法	ou'zhou'ci'dian'zhi'fa	0
欧洲慈姑	ou'zhou'ci'gu	0
欧洲醋栗	ou'zhou'cu'li	0
欧洲村	ou'zhou'cun	0
欧洲大奖赛	ou'zhou'da'jiang'sai	0
欧洲大陆	ou'zhou'da'lu	0
欧洲大陆会计	ou'zhou'da'lu'kuai'ji	0
欧洲大陆清真寺理事会	ou'zhou'da'lu'qing'zhen'si'li'shi'hui	0
欧洲大牌户外装备	ou'zhou'da'pai'hu'wai'zhuang'bei	0
欧洲大蚊	ou'zhou'da'wen	0
欧洲大叶杨	ou'zhou'da'ye'yang	0
欧洲待过	ou'zhou'dai'guo	0
欧洲道琼斯斯托克	ou'zhou'dao'qiong'si'si'tuo'ke	0
欧洲的缓和	ou'zhou'de'huan'he	0
欧洲的某个地方	ou'zhou'de'mou'ge'di'fang	0
欧洲的一天	ou'zhou'de'yi'tian	0
欧洲登记中心	ou'zhou'deng'ji'zhong'xin	0
欧洲电工标准化委员会	ou'zhou'dian'gong'biao'zhun'hua'wei'yuan'hui	0
欧洲电话传输基准参考系统	ou'zhou'dian'hua'chuan'shu'ji'zhun'can'kao'xi'tong	0
欧洲电信标准	ou'zhou'dian'xin'biao'zhun	0
欧洲电信标准协会	ou'zhou'dian'xin'biao'zhun'xie'hui	0
欧洲电信开发组织	ou'zhou'dian'xin'kai'fa'zu'zhi	0
欧洲电信研究与战略开发协会	ou'zhou'dian'xin'yan'jiu'yu'zhan'lve'kai'fa'xie'hui	0
欧洲电信研究与战略开发协会	ou'zhou'dian'xin'yan'jiu'yu'zhan'lve'kai'fa'xie'hui	0
欧洲电信研究与战略开发协会	ou'zhou'dian'xin'yan'jiu'yu'zhan'lve'kai'fa'xie'hui	0
欧洲电信研究与战略开发协会	ou'zhou'dian'xin'yan'jiu'yu'zhan'lve'kai'fa'xie'hui	0
欧洲鲽	ou'zhou'die	0
欧洲丁香	ou'zhou'ding'xiang	0
欧洲杜父鱼	ou'zhou'du'fu'yu	0
欧洲独立润滑剂制造商联合会	ou'zhou'du'li'run'hua'ji'zhi'zao'shang'lian'he'hui	0
欧洲椴	ou'zhou'duan	0
欧洲短毛猫	ou'zhou'duan'mao'mao	0
欧洲端青豆娘	ou'zhou'duan'qing'dou'niang	0
偶舟蛾属	ou'zhou'e'shu	0
欧洲发动机润滑油质量管理系统	ou'zhou'fa'dong'ji'run'hua'you'zhi'liang'guan'li'xi'tong	0
欧洲泛欧绩优	ou'zhou'fan'ou'ji'you	0
欧洲坊	ou'zhou'fang	0
欧洲房	ou'zhou'fang	0
欧洲防风	ou'zhou'fang'feng	0
欧洲房子	ou'zhou'fang'zi	0
欧洲风格	ou'zhou'feng'ge	0
欧洲犎牛	ou'zhou'feng'niu	0
欧洲凤尾藓	ou'zhou'feng'wei'xian	0
欧洲佛教	ou'zhou'fo'jiao	0
欧洲副狮子鱼	ou'zhou'fu'shi'zi'yu	0
欧洲复兴开发银行	ou'zhou'fu'xing'kai'fa'yin'hang	0
欧洲甘蓝	ou'zhou'gan'lan	0
欧洲鸽姬虱	ou'zhou'ge'ji'shi	0
欧洲共产主义	ou'zhou'gong'chan'zhu'yi	0
欧洲宫殿	ou'zhou'gong'dian	0
欧洲公共关系联盟会	ou'zhou'gong'gong'guan'xi'lian'meng'hui	0
欧洲公司法	ou'zhou'gong'si'fa	0
欧洲共同市场	ou'zhou'gong'tong'shi'chang	0
欧洲共同市场共	ou'zhou'gong'tong'shi'chang'gong	0
欧洲共同体	ou'zhou'gong'tong'ti	0
欧洲共同体审计法院	ou'zhou'gong'tong'ti'shen'ji'fa'yuan	0
欧洲工业园	ou'zhou'gong'ye'yuan	0
欧洲工业园二街	ou'zhou'gong'ye'yuan'er'jie	0
欧洲工业园路口	ou'zhou'gong'ye'yuan'lu'kou	0
欧洲工业园欧华路	ou'zhou'gong'ye'yuan'ou'hua'lu	0
欧洲谷蛾	ou'zhou'gu'e	0
欧洲谷蛾属	ou'zhou'gu'e'shu	0
欧洲故事	ou'zhou'gu'shi	0
欧洲股市	ou'zhou'gu'shi	0
欧洲冠军联赛	ou'zhou'guan'jun'lian'sai	0
欧洲管理会计师公会	ou'zhou'guan'li'kuai'ji'shi'gong'hui	0
欧洲管线管理中央署	ou'zhou'guan'xian'guan'li'zhong'yang'shu	0
欧洲广场	ou'zhou'guang'chang	0
欧洲光胸萤叶甲	ou'zhou'guang'xiong'ying'ye'jia	0
欧洲果蝽	ou'zhou'guo'chun	0
欧洲国际广播会议	ou'zhou'guo'ji'guang'bo'hui'yi	0
欧洲国家	ou'zhou'guo'jia	0
欧洲国家杯	ou'zhou'guo'jia'bei	0
欧洲果蛎圆蚧	ou'zhou'guo'li'yuan'jie	0
欧洲国债	ou'zhou'guo'zhai	0
欧洲海马	ou'zhou'hai'ma	0
欧洲航空安全局	ou'zhou'hang'kong'an'quan'ju	0
欧洲航空公司	ou'zhou'hang'kong'gong'si	0
欧洲蒿柳细蛾	ou'zhou'hao'liu'xi'e	0
欧洲豪庭	ou'zhou'hao'ting	0
欧洲核研究组织	ou'zhou'he'yan'jiu'zu'zhi	0
欧洲核子研究中心	ou'zhou'he'zi'yan'jiu'zhong'xin	0
欧洲黑松	ou'zhou'hei'song	0
欧洲黑条象	ou'zhou'hei'tiao'xiang	0
欧洲红魔	ou'zhou'hong'mo	0
欧洲红木	ou'zhou'hong'mu	0
欧洲红瑞木	ou'zhou'hong'rui'mu	0
欧洲划拨电子汇款	ou'zhou'hua'bo'dian'zi'hui'kuan	0
欧洲化学工业委员会	ou'zhou'hua'xue'gong'ye'wei'yuan'hui	0
欧洲桦瘿蚊	ou'zhou'hua'ying'wen	0
欧洲花园	ou'zhou'hua'yuan	0
欧洲花园西门	ou'zhou'hua'yuan'xi'men	0
欧洲环境署	ou'zhou'huan'jing'shu	0
欧洲黄鲂鮄	ou'zhou'huang'fang'fu	0
欧洲黄盖鲽	ou'zhou'huang'gai'die	0
欧洲汇率	ou'zhou'hui'lv	0
欧洲汇率机制	ou'zhou'hui'lv'ji'zhi	0
欧洲汇票	ou'zhou'hui'piao	0
欧洲汇市	ou'zhou'hui'shi	0
欧洲货	ou'zhou'huo	0
欧洲货币	ou'zhou'huo'bi	0
欧洲货币存款	ou'zhou'huo'bi'cun'kuan	0
欧洲货币贷款	ou'zhou'huo'bi'dai'kuan	0
欧洲货币单位	ou'zhou'huo'bi'dan'wei	0
欧洲货币定期存款	ou'zhou'huo'bi'ding'qi'cun'kuan	0
欧洲货币合作基金	ou'zhou'huo'bi'he'zuo'ji'jin	0
欧洲货币联盟	ou'zhou'huo'bi'lian'meng	0
欧洲货币市场	ou'zhou'huo'bi'shi'chang	0
欧洲货币体系	ou'zhou'huo'bi'ti'xi	0
欧洲货币通知存款	ou'zhou'huo'bi'tong'zhi'cun'kuan	0
欧洲货币协定	ou'zhou'huo'bi'xie'ding	0
欧洲货币信贷市场	ou'zhou'huo'bi'xin'dai'shi'chang	0
欧洲火车驾驶	ou'zhou'huo'che'jia'shi	0
欧洲基地	ou'zhou'ji'di	0
欧洲激动战线	ou'zhou'ji'dong'zhan'xian	0
欧洲吉松叶蜂	ou'zhou'ji'song'ye'feng	0
欧洲计算机制造商协会	ou'zhou'ji'suan'ji'zhi'zao'shang'xie'hui	0
欧洲记帐单位	ou'zhou'ji'zhang'dan'wei	0
欧洲记账单位	ou'zhou'ji'zhang'dan'wei	0
欧洲际准化委员会	ou'zhou'ji'zhun'hua'wei'yuan'hui	0
欧洲家具发展阶段	ou'zhou'jia'ju'fa'zhan'jie'duan	0
欧洲假期	ou'zhou'jia'qi	0
欧洲夹竹桃	ou'zhou'jia'zhu'tao	0
欧洲角龟	ou'zhou'jiao'gui	0
欧洲角龟的发现	ou'zhou'jiao'gui'de'fa'xian	0
欧州街	ou'zhou'jie	0
欧洲街	ou'zhou'jie	0
欧洲解放宣言	ou'zhou'jie'fang'xuan'yan	0
欧洲街口	ou'zhou'jie'kou	0
欧洲结算系统	ou'zhou'jie'suan'xi'tong	0
欧洲捷小唇泥蜂东方亚种	ou'zhou'jie'xiao'chun'ni'feng'dong'fang'ya'zhong	0
欧洲锦标赛	ou'zhou'jin'biao'sai	0
欧洲金融稳定机构	ou'zhou'jin'rong'wen'ding'ji'gou	0
欧洲金蝇	ou'zhou'jin'ying	0
欧洲经济	ou'zhou'jing'ji	0
欧洲经济共同体	ou'zhou'jing'ji'gong'tong'ti	0
欧洲经济委员会	ou'zhou'jing'ji'wei'yuan'hui	0
欧洲经济与货币联盟	ou'zhou'jing'ji'yu'huo'bi'lian'meng	0
欧洲精品	ou'zhou'jing'pin	0
欧洲酒	ou'zhou'jiu	0
欧洲酒廊	ou'zhou'jiu'lang	0
欧洲俱乐部冠军杯	ou'zhou'ju'le'bu'guan'jun'bei	0
欧洲蕨	ou'zhou'jue	0
欧洲卡车司机	ou'zhou'ka'che'si'ji	0
欧洲凯城园	ou'zhou'kai'cheng'yuan	0
欧洲康吉鳗	ou'zhou'kang'ji'man	0
欧洲可锻铸铁	ou'zhou'ke'duan'zhu'tie	0
欧洲科技信息网	ou'zhou'ke'ji'xin'xi'wang	0
欧洲空间局于	ou'zhou'kong'jian'ju'yu	0
欧洲空中客车工业公司	ou'zhou'kong'zhong'ke'che'gong'ye'gong'si	0
欧洲会计师联合会	ou'zhou'kuai'ji'shi'lian'he'hui	0
欧洲篮球联合会	ou'zhou'lan'qiu'lian'he'hui	0
欧洲廊	ou'zhou'lang	0
欧洲李	ou'zhou'li	0
欧洲栗	ou'zhou'li	0
欧洲栎斑螟	ou'zhou'li'ban'ming	0
欧洲理事会	ou'zhou'li'shi'hui	0
欧洲栎细蛾	ou'zhou'li'xi'e	0
欧洲栎叶蜂	ou'zhou'li'ye'feng	0
欧洲蛎鹬	ou'zhou'li'yu	0
欧洲联盟	ou'zhou'lian'meng	0
欧洲联盟杯	ou'zhou'lian'meng'bei	0
欧洲联赛	ou'zhou'lian'sai	0
欧洲林业委员会	ou'zhou'lin'ye'wei'yuan'hui	0
欧洲柳潜叶蜂	ou'zhou'liu'qian'ye'feng	0
欧洲瘤小蠹	ou'zhou'liu'xiao'du	0
欧洲蝼蛄	ou'zhou'lou'gu	0
欧洲萝卜	ou'zhou'luo'bo	0
欧洲罗汉松新叶蚜	ou'zhou'luo'han'song'xin'ye'ya	0
欧洲落叶松	ou'zhou'luo'ye'song	0
欧洲落叶松叶蜂	ou'zhou'luo'ye'song'ye'feng	0
欧洲绿魔	ou'zhou'lv'mo	0
欧洲马克债券	ou'zhou'ma'ke'zhai'quan	0
欧洲麦茎蜂	ou'zhou'mai'jing'feng	0
欧洲鳗	ou'zhou'man	0
欧洲鳗鲡	ou'zhou'man'li	0
欧洲鳗鲡病毒	ou'zhou'man'li'bing'du	0
欧洲猫尔菊	ou'zhou'mao'er'ju	0
欧洲美元	ou'zhou'mei'yuan	0
欧洲美元存款利率	ou'zhou'mei'yuan'cun'kuan'li'lv	0
欧洲美元利率	ou'zhou'mei'yuan'li'lv	0
欧洲美元期货	ou'zhou'mei'yuan'qi'huo	0
欧洲美元市场	ou'zhou'mei'yuan'shi'chang	0
欧洲美元债券	ou'zhou'mei'yuan'zhai'quan	0
欧洲民族套装	ou'zhou'min'zu'tao'zhuang	0
欧洲名坊名店	ou'zhou'ming'fang'ming'dian	0
欧洲名品	ou'zhou'ming'pin	0
欧洲名品中心别墅	ou'zhou'ming'pin'zhong'xin'bie'shu	0
欧洲名鞋馆	ou'zhou'ming'xie'guan	0
欧洲魔术	ou'zhou'mo'shu	0
欧洲南部	ou'zhou'nan'bu	0
欧洲男歌手	ou'zhou'nan'ge'shou	0
欧洲男篮锦标赛	ou'zhou'nan'lan'jin'biao'sai	0
欧洲男式水手服	ou'zhou'nan'shi'shui'shou'fu	0
欧洲男式战斗服	ou'zhou'nan'shi'zhan'dou'fu	0
欧洲拟鲤	ou'zhou'ni'li	0
欧洲泥蛉	ou'zhou'ni'ling	0
欧洲鸟嚼虱	ou'zhou'niao'jiao'shi	0
欧洲弄蝶	ou'zhou'nong'die	0
欧洲女歌手	ou'zhou'nv'ge'shou	0
欧洲女式水手服	ou'zhou'nv'shi'shui'shou'fu	0
欧洲女式战斗服	ou'zhou'nv'shi'zhan'dou'fu	0
欧洲欧洲	ou'zhou'ou'zhou	0
欧洲排放燃料及发动机技术计划	ou'zhou'pai'fang'ran'liao'ji'fa'dong'ji'ji'shu'ji'hua	0
欧洲盘前	ou'zhou'pan'qian	0
欧洲盘羊	ou'zhou'pan'yang	0
欧洲品牌	ou'zhou'pin'pai	0
欧洲扑克大师赛	ou'zhou'pu'ke'da'shi'sai	0
欧洲扑克巡回赛	ou'zhou'pu'ke'xun'hui'sai	0
欧洲葡萄	ou'zhou'pu'tao	0
欧洲桤斑螟	ou'zhou'qi'ban'ming	0
欧洲汽车模拟器	ou'zhou'qi'che'mo'ni'qi	0
欧洲期货交易所	ou'zhou'qi'huo'jiao'yi'suo	0
欧洲桤木扁叶蜂	ou'zhou'qi'mu'bian'ye'feng	0
欧洲桤木锤角叶蜂	ou'zhou'qi'mu'chui'jiao'ye'feng	0
欧洲桤木副长斑蚜	ou'zhou'qi'mu'fu'zhang'ban'ya	0
欧洲桤木黄叶蜂	ou'zhou'qi'mu'huang'ye'feng	0
欧洲桤木叶蜂	ou'zhou'qi'mu'ye'feng	0
欧洲期票	ou'zhou'qi'piao	0
欧洲期权	ou'zhou'qi'quan	0
欧洲七叶树	ou'zhou'qi'ye'shu	0
欧洲契约计划	ou'zhou'qi'yue'ji'hua	0
欧洲千里光	ou'zhou'qian'li'guang	0
欧宙青	ou'zhou'qing	0
欧洲球螋	ou'zhou'qiu'sou	0
欧洲全面战争	ou'zhou'quan'mian'zhan'zheng	0
欧洲人	ou'zhou'ren	0
欧洲日圆	ou'zhou'ri'yuan	0
欧洲日圆贷款	ou'zhou'ri'yuan'dai'kuan	0
欧洲日元债券	ou'zhou'ri'yuan'zhai'quan	0
欧洲润滑油工业技术协会	ou'zhou'run'hua'you'gong'ye'ji'shu'xie'hui	0
欧洲沙鼠	ou'zhou'sha'shu	0
欧洲沙鼠的发现	ou'zhou'sha'shu'de'fa'xian	0
欧洲山芥	ou'zhou'shan'jie	0
欧洲山梨	ou'zhou'shan'li	0
欧洲山毛榉	ou'zhou'shan'mao'ju	0
欧洲山杨	ou'zhou'shan'yang	0
欧洲山杨扁叶蜂	ou'zhou'shan'yang'bian'ye'feng	0
欧洲山杨黑斑病	ou'zhou'shan'yang'hei'ban'bing	0
欧洲山杨蚜	ou'zhou'shan'yang'ya	0
欧洲山杨叶蜂	ou'zhou'shan'yang'ye'feng	0
欧洲山杨叶甲	ou'zhou'shan'yang'ye'jia	0
欧洲山杨叶癭蚊	ou'zhou'shan'yang'ye'ying'wen	0
欧洲商城	ou'zhou'shang'cheng	0
欧洲梢小蠹	ou'zhou'shao'xiao'du	0
欧洲社会基金	ou'zhou'she'hui'ji'jin	0
欧洲摄影馆	ou'zhou'she'ying'guan	0
欧洲甚长基线干涉测量网络	ou'zhou'shen'chang'ji'xian'gan'she'ce'liang'wang'luo	0
欧洲审计院	ou'zhou'shen'ji'yuan	0
欧洲时段	ou'zhou'shi'duan	0
欧洲世家	ou'zhou'shi'jia	0
欧洲狮弄蝶	ou'zhou'shi'nong'die	0
欧洲式期权	ou'zhou'shi'qi'quan	0
欧洲时尚	ou'zhou'shi'shang	0
欧洲十一国游记	ou'zhou'shi'yi'guo'you'ji	0
欧洲食蚁兽	ou'zhou'shi'yi'shou	0
欧洲食用牡蛎	ou'zhou'shi'yong'mu'li	0
欧洲石油地学家和工程师协会	ou'zhou'shi'you'di'xue'jia'he'gong'cheng'shi'xie'hui	0
欧洲石油地质学家协会	ou'zhou'shi'you'di'zhi'xue'jia'xie'hui	0
欧洲石油添加剂制造商技术委员会	ou'zhou'shi'you'tian'jia'ji'zhi'zao'shang'ji'shu'wei'yuan'hui	0
欧洲瘦狮子鱼	ou'zhou'shou'shi'zi'yu	0
欧洲蔬菜饼	ou'zhou'shu'cai'bing	0
欧洲束颈蝗	ou'zhou'shu'jing'huang	0
欧洲束颈蝗指名亚种	ou'zhou'shu'jing'huang'zhi'ming'ya'zhong	0
欧洲数据处理协会联合会	ou'zhou'shu'ju'chu'li'xie'hui'lian'he'hui	0
欧洲数字无绳电话	ou'zhou'shu'zi'wu'sheng'dian'hua	0
欧洲栓皮栎	ou'zhou'shuan'pi'li	0
欧洲水貂	ou'zhou'shui'diao	0
欧洲菘蓝	ou'zhou'song'lan	0
欧洲松毛虫赤眼蜂	ou'zhou'song'mao'chong'chi'yan'feng	0
欧洲松毛虫黑卵蜂	ou'zhou'song'mao'chong'hei'luan'feng	0
欧洲松球蚜	ou'zhou'song'qiu'ya	0
欧洲酸樱桃	ou'zhou'suan'ying'tao	0
欧洲鳎	ou'zhou'ta	0
欧洲螳螂	ou'zhou'tang'lang	0
欧洲桃坚蚧	ou'zhou'tao'jian'jie	0
欧洲桃盔蚧	ou'zhou'tao'kui'jie	0
欧洲桃蜡蚧	ou'zhou'tao'la'jie	0
欧洲桃胎球蚧	ou'zhou'tao'tai'qiu'jie	0
欧洲特快车	ou'zhou'te'kuai'che	0
欧洲鳀	ou'zhou'ti	0
欧洲天然气车辆协会	ou'zhou'tian'ran'qi'che'liang'xie'hui	0
欧洲甜樱桃	ou'zhou'tian'ying'tao	0
欧洲天竺鲷	ou'zhou'tian'zhu'diao	0
欧洲铁路网移动系统项目	ou'zhou'tie'lu'wang'yi'dong'xi'tong'xiang'mu	0
欧洲通货市场	ou'zhou'tong'huo'shi'chang	0
欧洲投资银行	ou'zhou'tou'zi'yin'hang	0
欧洲菟丝子	ou'zhou'tu'si'zi	0
欧洲兔蚤	ou'zhou'tu'zao	0
欧洲湾	ou'zhou'wan	0
欧洲卫矛	ou'zhou'wei'mao	0
欧洲围棋大会	ou'zhou'wei'qi'da'hui	0
欧洲委员会	ou'zhou'wei'yuan'hui	0
欧洲委员会代用能源计划	ou'zhou'wei'yuan'hui'dai'yong'neng'yuan'ji'hua	0
欧洲屋	ou'zhou'wu	0
欧洲五大联赛	ou'zhou'wu'da'lian'sai	0
欧洲无鳍鳗	ou'zhou'wu'qi'man	0
欧洲无须鳕	ou'zhou'wu'xu'xue	0
欧洲线	ou'zhou'xian	0
欧洲线材展览会	ou'zhou'xian'cai'zhan'lan'hui	0
欧洲小镇	ou'zhou'xiao'zhen	0
欧洲新城	ou'zhou'xin'cheng	0
欧洲新城小区	ou'zhou'xin'cheng'xiao'qu	0
欧洲信贷业	ou'zhou'xin'dai'ye	0
欧洲新松叶蜂	ou'zhou'xin'song'ye'feng	0
欧洲行	ou'zhou'xing	0
欧洲杏凤蝶	ou'zhou'xing'feng'die	0
欧洲型贵公子	ou'zhou'xing'gui'gong'zi	0
欧洲性旅行	ou'zhou'xing'lv'xing	0
欧洲绣球	ou'zhou'xiu'qiu	0
欧洲蚜外茧蜂	ou'zhou'ya'wai'jian'feng	0
欧洲研究中心	ou'zhou'yan'jiu'zhong'xin	0
欧洲阳光城	ou'zhou'yang'guang'cheng	0
欧洲央行	ou'zhou'yang'hang	0
欧洲央行行长特里谢	ou'zhou'yang'hang'hang'zhang'te'li'xie	0
欧洲杨细蛾	ou'zhou'yang'xi'e	0
欧洲药典	ou'zhou'yao'dian	0
欧洲遥感卫星	ou'zhou'yao'gan'wei'xing	0
欧洲药品管理局	ou'zhou'yao'pin'guan'li'ju	0
欧洲业余棒球联合会	ou'zhou'ye'yu'bang'qiu'lian'he'hui	0
欧洲野猪	ou'zhou'ye'zhu	0
欧洲野猪的发现	ou'zhou'ye'zhu'de'fa'xian	0
欧洲议会	ou'zhou'yi'hui	0
欧洲伊斯兰理事会	ou'zhou'yi'si'lan'li'shi'hui	0
欧洲一体化	ou'zhou'yi'ti'hua	0
欧洲银行	ou'zhou'yin'hang	0
欧洲银行管理局	ou'zhou'yin'hang'guan'li'ju	0
欧洲银莲花	ou'zhou'yin'lian'hua	0
欧洲印前	ou'zhou'yin'qian	0
欧洲印象	ou'zhou'yin'xiang	0
欧洲印象怡景苑	ou'zhou'yin'xiang'yi'jing'yuan	0
欧洲映像商业街	ou'zhou'ying'xiang'shang'ye'jie	0
欧洲幼虫病	ou'zhou'you'chong'bing	0
欧洲幼虫腐臭病	ou'zhou'you'chong'fu'chou'bing	0
欧洲油松巢蛾	ou'zhou'you'song'chao'e	0
欧洲有线数据传输业务接口规范	ou'zhou'you'xian'shu'ju'chuan'shu'ye'wu'jie'kou'gui'fan	0
欧洲邮政管理协会	ou'zhou'you'zheng'guan'li'xie'hui	0
欧洲榆	ou'zhou'yu	0
欧洲魣	ou'zhou'yu	0
欧洲榆黄叶甲啮小蜂	ou'zhou'yu'huang'ye'jia'nie'xiao'feng	0
欧洲玉米螟	ou'zhou'yu'mi'ming	0
欧洲榆绒蚧	ou'zhou'yu'rong'jie	0
欧洲榆小蠹	ou'zhou'yu'xiao'du	0
欧洲语言文学	ou'zhou'yu'yan'wen'xue	0
欧洲苑	ou'zhou'yuan	0
欧洲圆盾蚧	ou'zhou'yuan'dun'jie	0
欧洲圆鳍罗鱼	ou'zhou'yuan'qi'luo'yu	0
欧洲越橘	ou'zhou'yue'ju	0
欧洲越桔华青苷胡萝卜素	ou'zhou'yue'ju'hua'qing'gan'hu'luo'bo'su	0
欧洲云杉	ou'zhou'yun'shan	0
欧洲云杉吉松叶蜂	ou'zhou'yun'shan'ji'song'ye'feng	0
欧洲云杉瘿蚊	ou'zhou'yun'shan'ying'wen	0
欧洲债券	ou'zhou'zhai'quan	0
欧洲债券市场	ou'zhou'zhai'quan'shi'chang	0
欧洲债务危机	ou'zhou'zhai'wu'wei'ji	0
欧洲站	ou'zhou'zhan	0
欧洲站防晒风衣	ou'zhou'zhan'fang'shai'feng'yi	0
欧洲站男短袖	ou'zhou'zhan'nan'duan'xiu	0
欧洲站男套装	ou'zhou'zhan'nan'tao'zhuang	0
欧洲战士男装	ou'zhou'zhan'shi'nan'zhuang	0
欧洲战士女装	ou'zhou'zhan'shi'nv'zhuang	0
欧洲站时尚羽绒服	ou'zhou'zhan'shi'shang'yu'rong'fu	0
欧洲站时尚羽绒服女	ou'zhou'zhan'shi'shang'yu'rong'fu'nv	0
欧洲站时尚羽绒服女新款	ou'zhou'zhan'shi'shang'yu'rong'fu'nv'xin'kuan	0
欧洲站羽绒服	ou'zhou'zhan'yu'rong'fu	0
欧洲站羽绒服女	ou'zhou'zhan'yu'rong'fu'nv	0
欧洲站羽绒服女新款	ou'zhou'zhan'yu'rong'fu'nv'xin'kuan	0
欧洲战争策源地	ou'zhou'zhan'zheng'ce'yuan'di	0
欧洲哲学史	ou'zhou'zhe'xue'shi	0
欧洲榛	ou'zhou'zhen	0
欧洲榛蚜茧蜂	ou'zhou'zhen'ya'jian'feng	0
欧洲支付同盟	ou'zhou'zhi'fu'tong'meng	0
欧洲质量管理组织	ou'zhou'zhi'liang'guan'li'zu'zhi	0
欧洲植物群	ou'zhou'zhi'wu'qun	0
欧洲之星	ou'zhou'zhi'xing	0
欧洲之夜	ou'zhou'zhi'ye	0
欧洲之最英国	ou'zhou'zhi'zui'ying'guo	0
欧洲中闭姬蜂	ou'zhou'zhong'bi'ji'feng	0
欧洲中程核武器谈判	ou'zhou'zhong'cheng'he'wu'qi'tan'pan	0
欧洲中国队	ou'zhou'zhong'guo'dui	0
欧洲中世纪	ou'zhou'zhong'shi'ji	0
欧洲中央银行	ou'zhou'zhong'yang'yin'hang	0
欧洲竹粉蠹	ou'zhou'zhu'fen'du	0
欧洲专利局	ou'zhou'zhuan'li'ju	0
欧洲专利局申诉委员会	ou'zhou'zhuan'li'ju'shen'su'wei'yuan'hui	0
欧洲锥螳	ou'zhou'zhui'tang	0
欧洲资金市场	ou'zhou'zi'jin'shi'chang	0
欧洲自由贸易联盟	ou'zhou'zi'you'mao'yi'lian'meng	0
欧洲综合铁路无线增强网络	ou'zhou'zong'he'tie'lu'wu'xian'zeng'qiang'wang'luo	0
欧洲足球协会联盟	ou'zhou'zu'qiu'xie'hui'lian'meng	0
欧洲最长的河流是伏尔加河	ou'zhou'zui'chang'de'he'liu'shi'fu'er'jia'he	0
欧洲最大半岛在北欧	ou'zhou'zui'da'ban'dao'zai'bei'ou	0
欧洲最大的半岛在	ou'zhou'zui'da'de'ban'dao'zai	0
欧洲最大的半岛在北欧	ou'zhou'zui'da'de'ban'dao'zai'bei'ou	0
欧洲最大的岛屿是大不列颠岛	ou'zhou'zui'da'de'dao'yu'shi'da'bu'lie'dian'dao	0
欧洲最佳专业技术数码单反相机	ou'zhou'zui'jia'zhuan'ye'ji'shu'shu'ma'dan'fan'xiang'ji	0
欧洲作家协会	ou'zhou'zuo'jia'xie'hui	0
欧朱	ou'zhu	0
欧珠	ou'zhu	0
沤苎成鱼网	ou'zhu'cheng'yu'wang	0
偶逐东风转良夜	ou'zhu'dong'feng'zhuan'liang'ye	0
偶逐干禄徒	ou'zhu'gan'lu'tu	0
沤珠槿艳	ou'zhu'jin'yan	0
偶逐青萝居	ou'zhu'qing'luo'ju	0
偶烛施明	ou'zhu'shi'ming	0
欧猪四国	ou'zhu'si'guo	0
沤纻为缊袍	ou'zhu'wei'yun'pao	0
偶拄乌藤出苔径	ou'zhu'wu'teng'chu'tai'jing	0
偶助笑歌嘲阿软	ou'zhu'xiao'ge'chao'a'ruan	0
偶逐簪组辈	ou'zhu'zan'zu'bei	0
欧专局	ou'zhuan'ju	0
偶转转	ou'zhuan'zhuan	0
偶庄	ou'zhuang	0
欧庄	ou'zhuang	0
藕庄	ou'zhuang	0
鸥庄	ou'zhuang	0
欧庄村	ou'zhuang'cun	0
呕幢风	ou'zhuang'feng	0
欧庄原道	ou'zhuang'yuan'dao	0
欧庄原道路	ou'zhuang'yuan'dao'lu	0
欧准	ou'zhun	0
偶子	ou'zi	0
欧兹	ou'zi	0
欧子	ou'zi	0
欧资	ou'zi	0
偶兹近精庐	ou'zi'jin'jing'lu	0
偶兹叩精庐	ou'zi'kou'jing'lu	0
欧兹男装新款	ou'zi'nan'zhuang'xin'kuan	0
欧兹瑞尔	ou'zi'rui'er	0
偶自生	ou'zi'sheng	0
欧子欣	ou'zi'xin	0
欧姿雅	ou'zi'ya	0
欧总监	ou'zong'jian	0
欧足联	ou'zu'lian	0
欧足联总部	ou'zu'lian'zong'bu	0
欧钻兰	ou'zuan'lan	0
偶最后一次	ou'zui'hou'yi'ci	0
鸥嘴噪鸥	ou'zui'zao'ou	0
偶作	ou'zuo	0
偶坐吹横笛	ou'zuo'chui'heng'di	0
偶坐得棋圣	ou'zuo'de'qi'sheng	0
偶作二首	ou'zuo'er'shou	0
欧佐夫符镇兵	ou'zuo'fu'fu'zhen'bing	0
欧佐夫公会门	ou'zuo'fu'gong'hui'men	0
欧佐夫护符	ou'zuo'fu'hu'fu	0
欧佐夫僭位卡娅	ou'zuo'fu'jian'wei'ka'ya	0
欧佐夫敲诈人	ou'zuo'fu'qiao'zha'ren	0
欧佐夫示石	ou'zuo'fu'shi'shi	0
欧佐夫执法者	ou'zuo'fu'zhi'fa'zhe	0
欧佐夫坠饰	ou'zuo'fu'zhui'shi	0
偶坐更相悲	ou'zuo'geng'xiang'bei	0
偶作关东使	ou'zuo'guan'dong'shi	0
偶作寄朗之	ou'zuo'ji'lang'zhi	0
偶作寄王秘书	ou'zuo'ji'wang'mi'shu	0
偶作郊原十日游	ou'zuo'jiao'yuan'shi'ri'you	0
欧佐晶岩	ou'zuo'jing'yan	0
偶坐烂明星	ou'zuo'lan'ming'xing	0
偶佐山水乡	ou'zuo'shan'shui'xiang	0
偶坐似是商山翁	ou'zuo'si'shi'shang'shan'weng	0
偶坐似是庄与惠	ou'zuo'si'shi'zhuang'yu'hui	0
欧佐瓦赋礼	ou'zuo'wa'fu'li	0
偶坐为林泉	ou'zuo'wei'lin'quan	0
偶坐为六子	ou'zuo'wei'liu'zi	0
偶坐翛然洗我心	ou'zuo'xiao'ran'xi'wo'xin	0
偶坐阴松桧	ou'zuo'yin'song'gui	0
